先礼后兵	兵不厌诈||突然袭击
帮凶	元凶||正凶
上	下
未可厚非	一无是处
梗概	细节
尖嘴猴腮	肥头大耳||风流潇洒
涩	滑
还帐	借帐||欠帐
腻烦	喜欢
平铺直叙	起伏跌宕||天花乱坠||穷形尽相||抑扬顿挫
轻诺寡信	一诺千金
疾言厉色	巧言令色||和颜悦色
乌合之众	如鸟兽散||坚甲利兵
迟缓	迅速
以下	以上
得胜回朝	落花流水||全军覆没||落荒而逃
过晌	头晌
乡间	城里
充耳不闻	洗耳恭听||有闻必录
事先请示	先斩后奏
无事生非	安分守己
昏暗	明亮||皎浩||明朗
至少	至多
不堪造就	大器晚成||大有可为
斤斤计较	大处着眼||鸡虫得失||宽宏大量
全心全意	朝三暮四
涨	缩||降
创业	守业
墨吏	清官
抱残守缺	革故鼎新
行同陌路	称兄道弟||花前月下||互为表里||一见如故
岿然不动	风雨飘摇||逃之夭夭||摇摇欲坠
上冻	解冻
自作聪明	自知之明
跋山涉水	一路顺风
贬	褒
地旷人稀	人烟稠密
黑糊糊	亮堂堂
偷工减料	一丝不苟||精雕细刻
依附	摆脱
难解难分	一刀两断
百折不挠	因噎废食||一蹶不振
三天打鱼，两天晒网	锲而不舍||坚持不懈
指不胜屈	屈指可数
洞察秋毫	浮光掠影
荆钗布裙	凤冠霞帔||珠围翠绕||珠光宝气
强大	弱小
增	减||删
见机而作	鲁莽行事
锱铢必较	鸡虫得失
保障	侵犯
本末倒置	本末相顺
心灰意冷	信心百倍
有效	无效
购置	变卖
受戒	破戒
拘泥	灵活
熟手	生手
唯我独尊	虚己以听||虚怀若谷
雌	雄
恶	善||好
顾盼自雄	招兵买马
自是	虚心
普天同庆	怨声载道||哀鸿遍野
时不我待	得过且过||无所事事
走投无路	柳暗花明||绝处逢生||鹏程万里
得势	失势
矢口否认	供认不讳
兴利除弊	陈陈相固||萧规曹随
抛头露面	隐姓埋名
摄政	亲政
情同陌路	夫唱妇随
保持	流失
疾恶如仇	同流合污||从善如流
得而复失	转危为安
胡言乱语	有条不紊||有凭有据
中听	难听
不厌其烦	下不为例
过河拆桥	饮水思源||风雨同舟
庸人	天才
无地自容	理直气壮||问心无愧||立足之地
插翅难飞	轻而易举
颠扑不破	不攻自破
公道	偏心
简明扼要	长篇大论||床上安床||盘根错节||洋洋洒洒||长篇累牍
华而不实	表里如一
添油加醋	实事求是
两全其美	两败俱伤||玉石俱焚
迎风	背风
习以为常	触目惊心||千载难逢||少见多怪
隔岸观火	见义勇为||唇亡齿寒||身临其境
入选	落选
药到病除	无可救药
促进	促退
联系	脱离||孤立||脱节
一手包办	群策群力
不足	充分||有余
无足轻重	非同小可||举足轻重||燃眉之急||人命关天
国泰民安	国步艰难||内忧外患||生灵涂炭||狼烟四起||民不聊生
喜不自胜	闷闷不乐||怒形于色
杞人忧天	若无其事
蔫巴	欢实
眼前	长远
愚不可及	大巧若拙
人心惶惶	镇定自若||泰然自若
空荡荡	满登登
买空卖空	童叟无欺
老气横秋	朝气蓬勃||老当益壮||生机勃勃||老骥伏枥||生龙活虎
模棱两可	旗帜鲜明||彰明较著||不言而喻||显而易见
检点	放荡||放诞||放肆
序言	后记
万箭攒心	兴高采烈
垂涎三尺	不屑一顾||视如敝屣
南辕北辙	马首是瞻||殊途同归
山明水秀	穷山恶水
加剧	减轻
统销	统购
关心	冷落
目光如豆	料事如神||高瞻远瞩||目光如炬
不明不白	一清二楚
令人作呕	令人神往||赞不绝口||楚楚可怜||沁人心脾
放下屠刀	困兽犹斗
无可比拟	不相上下||等量齐观
心中有数	稳操胜券||胸中无数||心中无数||一无所知
付出	收回||索取
久居故里	人去楼空
探囊取物	缘木求鱼
公家	私人
坦然自若	心惊胆战
唉声叹气	豪言壮语
天诛地灭	天经地义
日新月异	一成不变||故步自封
国无宁日	天下太平
历历可数	昏天黑地||漆黑一团
债台高筑	绰有余裕
劳苦功高	徒劳无益||劳而无功
绳床瓦灶	堆金积玉||锦衣玉食
拐弯抹角	直截了当||单刀直入
细心	粗心
暮气沉沉	生气勃勃||血气方刚
竭尽全力	养精蓄锐
纸上谈兵	脚踏实地||身经百战||埋头苦干
一往情深	朝秦暮楚||食肉寝皮||卸磨杀驴||朝三暮四
同一	对立
贻人口实	无瑕可击
慢条斯理	不假思索||急不可待||迫在眉睫||手足无措||慌里慌张||急如星火||一日千里
格格不入	得意忘言||情景交融||如影随形||水乳交融||物以类聚||心有灵犀一点通||臭味相投||心心相印
战天斗地	乐天知命
回	去
蜻蜓点水	脚踏实地||下马观花||铺天盖地||下马看花
独当一面	仰人鼻息||俯仰由人
万众一心	各奔前程||挂一漏万||四分五裂||一盘散沙
不尴不尬	泰然自若
阻塞	畅通||通过
大有可为	不堪造就||碌碌无为||碌碌无能
送	收||夺||接
奇耻大辱	光宗耀祖||丰功伟绩
一蹶不振	百折不挠||平步青云||一步登天||东山再起||死灰复燃
史不绝书	前所未闻||前所未有
破碎	完整
欢天喜地	苦海无边||心如刀割||泣不成声||寻死觅活
众志成城	孤掌难鸣||一盘散沙
湿漉漉	干巴巴
停飞	放飞
锦衣玉食	布被瓦器||绳床瓦灶
沉冤莫白	平反昭雪
欲言又止	指天画地
新来乍到	故地重游
预习	复习
节减	增加
老谋深算	入世不深||初出茅庐
肥大	瘦小
不二法门	歪门邪道
纪律	自由
辗转	直接
图谋不轨	安分守己
完好无缺	残缺不全
白手起家	根基深厚||寄人篱下
肃静	嘈杂||吵闹
标	本
糖衣炮弹	一尘不染
恰如其分	过犹不及||举措不当||离题万里||添枝加叶
归纳	演绎
传宗接代	后继无人
俯首贴耳	不卑不亢
应届	历届
光彩夺目	黯然失色
饱	饿||饥
平坦	崎岖||坎坷||陡峭
无所不通	一窍不通
气象万千	百孔千疮||每况愈下
乌七八糟	井然有序
最大公约数	最小公倍数
吉人天相	多灾多难||劫后余生||生不逢时||生不逢辰
凌乱	整齐
安居乐业	家破人亡||流离颠沛||民不聊生||戎马倥偬||十室九空||无家可归||流离失所
耻辱	光荣||荣誉
宝货难售	奇货可居
千锤百炼	粗制滥造
随俗	超然
浮光掠影	洞察秋毫||刻骨铭心||语重心长||一丝不苟
朝三暮四	墨守成规||矢志不渝||一往情深||全心全意
铁树开花	触目皆是||轻而易举
闻鸡起舞	自暴自弃
日暮途穷	飞黄腾达||来日方长||前程万里||方兴未艾||如日方升
减缩	扩展
景慕	鄙夷
疲于奔命	以逸待劳||悠闲自得||优游自在
玩物丧志	业精于勤
锐角	钝角
衰落	兴盛||昌盛
污	清
解除	保留
劣	优||良
脱靶	中靶
一无所能	拿手好戏||胜任愉快
任用	免职
冻冰	开化
接触	离开
甘拜下风	先声夺人||自命不凡||不甘示弱||迎头赶上||争长论短
不胜枚举	聊胜于无
寸草不生	郁郁葱葱||肥田沃土
风起云涌	风流云散
江河日下	如日方升||蒸蒸日上||飞黄腾达||突飞猛进
晋级	降级
假人假义	坦诚相见||肝胆相照
严寒	酷热||酷暑
等量齐观	无可比拟
累牍连篇	片纸只字||片言只字
兔起鹘落	拖泥带水||蜗行牛步
迥然不同	不相上下||毫无二致||并驾齐驱||大同小异
赶尽杀绝	慈悲为怀
说和	挑拨
短命	长寿
广义	狭义
低微	高亢||强烈
不得而知	了如指掌||洞若观火
刚正不阿	阿谀逢迎||官官相护||趋炎附势||胁肩谄笑||阿谀奉承
退避三舍	锋芒毕露||以眼还眼，以牙还牙||针锋相对
狼心狗肺	赤子之心||一寸丹心
成年	幼年
翻天覆地	一成不变
畏缩不前	奋勇当先||所向披靡||铤而走险||首当其冲||挺身而出
招兵买马	顾盼自雄||孤军作战
若隐若现	黑白分明||一目了然
循环往复	始终如一
水火不相容	水乳交融
胸襟坦荡	心怀叵测
金碧辉煌	黯然无光
精兵猛将	老弱残兵
诗情画意	平淡无奇
珠圆玉润	不堪入耳
乖巧	蠢笨||愚笨
呼幺喝六	低声下气
公海	内海||领海
卖国	爱国
满腔热枕	漠不关心
烘云托月	开门见山
轩然大波	风平浪静
流畅	晦涩||别扭||艰涩||枯涩||生涩||阻塞
人命关天	无足轻重
有口无心	言必有中
渊博	浅薄||鄙陋||贫乏
明了	含混
报仇雪恨	负屈含冤
尸骨未寒	墓木已拱
愁苦	欢乐
受宠若惊	麻木不仁
秋毫之末	重于泰山
狭义	广义
血肉相连	漠不关心||不关痛痒
进步	落后||堕落||反动
巨细无遗	窥豹一斑
盘马弯弓	不得不发||引而不发||立竿见影
进退两难	进退自如||无往不利
心惊胆战	泰然自若||坦然自若
腴	瘠
终	始
任劳任怨	拈轻怕重||聊以塞责
蝇营狗苟	光明磊落
无情	多情
轻徭薄赋	横征暴敛
讨价还价	宽宏大量||三言两语
年底	年初
奇谈怪论	义正言辞
海外奇谈	言之有据||确凿不移
谋财害命	仗义疏财
官邸	私邸
迟	快
克勤克俭	挥霍无度||尸位素餐
伤天害理	乐善好施||仰不愧天
细嫩	粗糙
月晕	日晕
前仆后继	苟且偷生||贪生怕死
水磨工夫	操之过急
口不应心	言行一致
赞颂	批判
不可思议	情有可原||可想而知
微观	宏观
学以致用	学非所用||用非所学
遐迩闻名	默默无闻
死心塌地	举棋不定||犹豫不决
放行	阻拦||阻截
胁肩谄笑	刚正不阿
纠缠不清	一刀两断
苦尽甘来	乐极生悲
寒微	富贵
急流勇进	急流勇退
围魏救赵	声东击西||围城打援
天经地义	荒谬绝伦||似是而非||天诛地灭
骄傲自满	不吝指教||谦虚谨慎||学而不厌
攀龙附凤	视同路人||敬而远之
匠心独运	因循守旧||墨守成规
杀气腾腾	心慈手软||心平气和
知过必改	明知故犯||将错就错
彰明较著	语焉不详||模棱两可
不乏其人	寥寥无几
吐故纳新	招降纳叛
加强	削弱
筋疲力尽	精力充沛||精神焕发||精神抖擞||容光焕发
心服	口服
与日俱增	每况愈下
欺人太甚	与人为善||童叟无欺
杰出	平凡||凡庸||平庸
美化	丑化
后会有期	后会难期
艰苦朴素	铺张浪费||穷奢极侈
掩人耳目	众目昭彰||众目睽睽
丢弃	拾取
无名	著名
豪放不羁	画地为牢||畏首畏尾
望而却步	勇往直前
寄存	领取
无计可施	机关算尽||急中生智||千方百计||想方设法
确实	虚假
苦咧咧	甜津津||甜丝丝
小肚鸡肠	大度包容||网开一面
恼羞成怒	心平气和
酸甜苦辣	四大皆空
白文	朱文
被动	主动
乐	愁||哀||忧
父老兄弟	一官半职
盖	开
淡泊寡味	馋涎欲滴||垂涎欲滴
婀娜多姿	丑态百出
缓和	紧张
声母	韵母
粗暴	温和||和蔼||和气||温柔
妒贤嫉能	知人善任
精华	糟粕
学富才高	学浅才疏
岂有此理	合情合理
端端正正	歪歪斜斜
乐极生悲	及时行乐||乐不可支||因祸得福||苦尽甘来||乐而忘返
收集	释放||散发
广开言路	拒谏饰非
唯唯诺诺	降龙伏虎||强头倔脑
未雨绸缪	亡羊补牢
老当益壮	老气横秋||倚老卖老||未老先衰
妄自菲薄	目空一切||妄自尊大||夜郎自大
鸠形鹄面	脑满肠肥
向心力	离心力
全神贯注	麻痹大意||心不在焉||漫不经心
空虚	充实
散	聚
提	推
共同	单独
日积月累	挥霍无度||一曝十寒
刚愎自用	博采众长||满招损，谦受益
云合雾散	如鸟兽散
事实	谎言
单	双
苦海无边	欢乐无涯||欢天喜地
繁荣富强	赤地千里||民困国贫
表	里
动	静
安居乐道	无妄之灾
兴师问罪	负荆请罪
一相情愿	两相情愿
根本	枝节
大家闺秀	小家碧玉
丑化	美化
水性杨花	冰清玉洁
匿名	具名
活跃	沉闷
鸣金收兵	大动干戈||调兵遣将
穷乡僻壤	鸟语花香||通都大邑||沃野千里||十字街头||万人空巷
盛世	乱世
纵	横
同室操戈	同仇敌忾
致人死地	治病救人
原原本本	有头无尾||东鳞西爪
津津有味	枯燥无味||味同嚼蜡||索然无味
一帆风顺	好事多磨||节外生枝||逆水行舟||势成骑虎||一波三折||横生枝节
自诉	公诉
不同凡响	不过尔尔
落日	旭日
荣誉	耻辱
百姓	官吏
旁若无人	众目睽睽
稀稀拉拉	密密麻麻||密密丛丛
放	收||抓
隔靴搔痒	切中要害||一语破的||一针见血
广	窄
老练	幼稚
闰年	平年
预演	公演
再接再厉	得过且过
蹑足其闷	坐观成败
突变	渐变
国富民强	国步艰难
乐此不疲	心不在焉||心猿意马
深奥	浅显||粗浅||浅近
扬长而去	恋恋不舍
燃眉之急	无关大局||无足轻重
跳梁小丑	志士仁人||正人君子
如影随形	格格不入
哀	乐
晨	昏
荤	素
金无足赤，人无完人	十全十美||完美无缺
沃野千里	穷乡僻壤
农闲	农忙
顾影自怜	妄自尊大
一钱不值	价值连城
顺手	棘手||辣手||扎手
升	降
提高	降低
大张旗鼓	秘而不宣||不露声色||偃旗息鼓
沉没	漂浮
痛心疾首	感恩戴德
小年	大年
称赞	谴责
升涨	下跌
言简意赅	床上安床||鸿篇巨制||陈词滥调||大块文章
不明真相	洞烛其奸
为所欲为	安贫乐道||规行矩步
虾兵蟹将	爪牙之将
销兵洗甲	剑拔弩张
父系	母系
七零八落	浑然一体||络绎不绝||井井有条
拆伙	合伙
轻车熟路	人生地疏
抱恨终天	心甘情愿||死而无憾
少不更事	后生可畏||少年老成||饱经风霜||老马识途||深谋远虑
偏食	全食
得意忘言	格格不入
恩深义厚	血债累累
济困扶危	落井下石||乘人之危||自私自利
深入浅出	隐晦曲折
外圆内方	外强中干||外方内圆
一误再误	知错改错
正式	暂行
死不瞑目	心甘情愿||何乐不为
恭谨	轻狂
决断如流	优柔寡断
三生有幸	天不作美||生不逢时
小本经营	富可敌国
走头无路	方便之门
树大招风	无名小卒
发昏	清醒
哀毁骨立	笑逐颜开||哀而不伤
博学多才	不辨菽麦||才疏学浅||一得之见||不学无术||胸无点墨
否极泰来	福过灾生
速战速决	缓兵之计
为渊驱鱼	损人利己
穷困	富裕||宽裕
无言以对	反唇相稽||反唇相讥||对答如流
大书特书	不在话下||轻描淡写
奋起直追	踌躇不前
薰莸同器	泾渭分明
拔寨起营	安营扎寨
循名责实	徒慕虚名
哗众取宠	实事求是
望洋兴叹	妄自尊大
立于不败之地	屡战屡败
梧鼠技穷	神通广大
大张挞伐	和平共处
厚道	刻薄
负隅顽抗	束手就擒
腰缠万贯	不名一钱||阮囊羞涩||一无长物
瞻前顾后	顶天立地||披荆斩棘||排除万难||一往直前||义无反顾
从井救人	落井下石
啼饥号寒	家给人足
地府	天堂
生搬硬套	融会贯通||相机行事
横生枝节	一帆风顺||顺水推舟
南柯一梦	如意算盘
好过	难过
令行禁止	温文尔雅||和风细雨
有凭有据	胡言乱语
清澈见底	污泥浊水
归功	归罪
三心二意	全力以赴||心无二用||专心致志||不遗余力
长年累月	一朝一夕
老生常谈	真知灼见
甜	苦
封锁	开放
百里挑一	残渣余孽
聚集	分散||弥散
奋不顾身	贪生怕死||视为畏途
为虎作伥	劫富济贫
不闻不问	不甘寂寞||明知故问
聊胜于无	不胜枚举||不计其数
结果	原因||原由
赫赫名流	无名小卒
迷途知返	流连忘返||执迷不悟||一意孤行
气味相投	针锋相对
煽风点火	排忧解难
绰有余裕	债台高筑
济济一堂	分道扬镳||一盘散沙||不欢而散
艰难	安适||容易
国营	私营
安如磐石	九死一生||危如累卵||摇摇欲坠||千钧一发
毕业	肄业
老	少
荣	枯
离题万里	字斟句酌||恰如其分
内务	外交
明知故问	不闻不问
神采奕奕	没精打采||无精打采||萎靡不振||心力交瘁
抛锚	起锚||启碇||起碇
鬼	人
走马观花	下马看花
急转直下	扶摇直下||相持不下||扶摇直上
一览无余	一鳞半爪
小巧玲珑	庞然大物
贬低	抬高
野	朝
里应外合	孤立无援||孤军深入
黄梁美梦	如梦方醒
迷恋	抛弃
不堪回首	大喜过望||喜出望外
匿影藏形	粉墨登场||原形毕露||水落石出||招摇过市
信口雌黄	言之凿凿
呶呶不休	沉默寡言
元凶	帮凶
动如脱兔	静如处女
费事	省事
惩前毖后	先来后到
如坐针毡	泰然自若||安之若素||心安理得
恬不知耻	汗颜无地
高昂	低落
休	戚
计日程功	旷日持久
守势	攻势
反目成仇	辅车相依||秦晋之好||如胶似漆||同舟共济||如胶如漆||手足之情||相亲相爱
善意	恶意||敌意
争权夺利	淡泊明志
前呼后拥	轻装简从||轻车简从||形单影只
垂头丧气	踌躇满志||得意洋洋||高歌猛进||气宇轩昂||沾沾自喜||额手称庆||眉飞色舞||昂首挺胸
怯弱	勇敢
毛渠	干渠
患难与共	貌合神离
福如东海	时乖命骞||生不逢时
百废俱兴	百废不举||每况愈下
曲径通幽	繁华闹市
乖觉	愚蠢
自高自大	不矜不伐||虚怀若谷||不耻下问
侧目而视	目不斜视
大相径庭	大同小异||异口同声||两相情愿
正路	邪路
聚精会神	漫不经心||魂不守舍||心不在焉
八斗之才	胸无点墨
撤防	设防
委靡	振作
增添	减少||削减
晓畅	晦涩
标新立异	墨守陈规||拾人牙慧
还礼	敬礼
出笼	回笼
片刻	良久||长久
打破常规	清规戒律
似水流年	度日如年
精良	粗劣
弹尽粮绝	源源不断
横征暴敛	轻徭薄赋
辩护	批驳
表露	掩盖
因陋就简	富丽堂皇||扬长避短
肉食	草食
一溃千里	旗开得胜
安分守己	横行霸道||胡作非为||惹事生非||偷香窃玉||为非作歹||无法无天||无所不为||横行无忌||图谋不轨||无事生非
轻贱	高贵
百读不厌	索然无味
一言九鼎	人微言轻
外姓	本家
自知之明	非分之想||自作聪明
深谋远虑	急公近利||少不更事
割除	保留
弄瓦	弄璋
下行	上行
现实主义	浪漫主义
鹑衣百结	凤冠霞帔||衣冠楚楚
删繁就简	叠床架屋||拖泥带水
发达	落后
一命呜呼	长命百岁
马到成功	弃甲丢盔||头破血流||屡战屡败
适宜	失宜
问	答
富翁	穷人
泰然自若	不尴不尬||人心惶惶||丧魂落魄||忐忑不安||心惊胆战||心有余悸||如坐针毡||失魂落魄||闻风丧胆
细针密缕	粗枝大叶||大刀阔斧
愁眉不展	满面春风||眉开眼笑
约数	确数
孙	祖
天衣无缝	漏洞百出||千疮百孔||破绽百出
羽翼已成	羽毛未丰
立功赎罪	十恶不赦||罪上加罪
抚危济贫	趁火打劫
呆若木鸡	奔走相告||神色自若
夫妻反目	百年之好
清规戒律	推陈出新||打破常规
归去来兮	四海为家||浪迹天涯
放倒	扶起||竖立
繁华闹市	曲径通幽
正取	备取
重	轻
管束	放纵
游刃有余	勉为其难||捉襟见肘||一筹莫展||智尽能索
纲	目
芝兰之室	鲍鱼之肆
徇私舞弊	大公无私||公事公办||营私舞弊||天公地道
导热	隔热
喜新厌旧	坚定不移||惜玉怜香||地久天长||怜香惜玉
铺张浪费	节衣缩食||省吃俭用||艰苦朴素||开源节流
背阴	向阳
绵里藏针	剑拔弩张
开明	顽固
刀枪入库	秣马厉兵
浊泾清渭	是非不分
孝子	逆子
从善如流	独断专行||疾恶如仇
迎风招展	偃旗息鼓
含蓄	浅露
一表人才	其貌不扬
如臂使指	束手无策||势成骑虎
正中	旁边
城狐社鼠	光明正大
垂帘听政	包而不办
东窗事发	秘而不宣
挑拨离间	精诚团结
罪大恶极	功德无量||功昭日月
心有灵犀一点通	格格不入||貌合神离
善始善终	功亏一篑||有始无终
着	熄||灭
慷慨激昂	无精打采||委靡不振
如狼似虎	如兄如弟||菩萨心肠
才高八斗	才疏志浅
持平之论	一孔之见||偏听偏信
望风而逃	冲锋陷阵||勇往直前
郑重其事	满不在乎
富余	缺少
漆黑一团	博古通今||历历可数||目迷五色||云蒸霞蔚||光芒万丈
才高行洁	缺德少才||才疏学浅
劳师动众	按兵不动
麻痹大意	常备不懈||严阵以待||安不忘危||全神贯注
稳	慌
力所能及	力不能支||无能为力||力不从心
鄙视	重视
松软	坚硬
水深火热	人寿年丰
人杰地灵	绸人广众||人稠物穰
天网恢恢，疏而不漏	逍遥法外
辟谣	造谣
充分	不足
留用	革除
豁达大度	鼠肚鸡肠||心胸狭窄
拉	推
一拖再拖	当务之急
舜日尧天	豺狼当道
萧规曹随	破旧立新||兴利除弊
材料	观点
偿还	拖欠||借贷
知错不改	亡羊补牢||闻过则喜
三顾茅庐	拒人千里||妄自尊大
言之成理	妄下雌黄
管中窥豹	一目了然||洞若观火
两相情愿	大相径庭||一厢情愿||一相情愿
那	这
气冲牛斗	低声下气
应运而生	生不逢辰
守业	创业
摇摆不定	坚韧不拔||坚忍不拔
归并	分开
秋高气爽	春雨绵绵
急躁	温和||耐心
自始至终	有头无尾
功臣	罪人
不期而遇	失之交臂
平	皱||陡
胡作非为	安贫乐道||秋毫无犯||安分守己||循规蹈矩
人造	天然
魂不守舍	聚精会神||心无二用
筑室道谋	一心一意||当机立断
战争	和平
迫不及待	待机而动
损害	爱护||保护
坚强不屈	卑躬屈膝
忘掉	记住
清凉	闷热||燥热||炎热
哑口无言	反唇相稽||振振有辞||滔滔不绝
蒸蒸日上	江河日下||日薄西山||心劳日拙||不可收拾||世风日下||行将就木
战	和
百无聊赖	怡然自得||兴高采烈
初版	再版
瞠乎其后	并驾齐驱
一发千钧	稳如泰山
中断	继续
多多益善	不忮不求||适可而止||清心寡欲
退火	淬火
放开手脚	缩手缩脚
主证	旁证
平易近人	刁钻古怪||飞扬跋扈||炙手可热||咄咄逼人
不易之论	不经之谈||无稽之谈
未然	已然
不急之务	当务之急
高官厚禄	门可罗雀
勇挑重担	拈轻怕重
戚	休
人微言轻	一言千金||一言九鼎
战无不胜	一触即溃
夕阳西下	旭日东升
栽	拔
风和日丽	飞沙走石||风吹雨打||风雨如晦||天昏地暗
量力而行	不自量力||力不从心||螳臂当车||眼高手低
公事公办	徇私舞弊||假公济私
苟延残喘	视死如归||宁死不屈
余勇可贾	无能为力
栋梁之材	斗筲之材
以短击长	扬长避短
空洞无物	微言大义
摈弃	吸取
虚构	写实
谦虚	骄傲||骄慢||狂妄||自负
死敌	契友||至交
节约	浪费
畏葸不前	无所畏惧||自告奋勇
全知全能	一窍不通
反抗	压迫||屈服||驯服
死灰复燃	石沉大海||一蹶不振||销声匿迹
无稽之谈	不刊之论||不易之论||言之凿凿||不容置疑
安安静静	天旋地转
欲速不达	瓜熟蒂落
极乐世界	不毛之地
大我	小我
末了	起头
越级	逐级
矫揉造作	天真烂漫
落井下石	从井救人||济困扶危||雪中送炭||治病救人||成人之美||扶危济困||救死扶伤
生死与共	你死我活||自相鱼肉
隐没	出现||显现
大量	少量||少许
瑕瑜互见	白璧无瑕||完美无缺
萍踪浪迹	安家立业
自得其乐	悲天悯人
果	因
断断续续	接连不断||源源不绝||源源不断||连续不断||连连贯贯
白璧无瑕	白壁微瑕||瑕瑜互见||白璧微瑕
相得益彰	两败俱伤||欲盖弥彰||势不两立
蓄发	削发
流动	凝滞||固定
起用	免职
真情	假意
养痈成患	斩尽杀绝||不留余地
庸才	天才||干才
大样	小样
水中捞月	立竿见影
震撼人心	静若秋水||无动于衷
长篇累牍	简明扼要
空空如也	应有尽有||包罗万象
生死攸关	无关痛痒
幸福	痛苦||苦难||悲惨
夜班	白班
友爱	仇恨
同日而语	较短论长||分门别类
温柔	粗暴||凶恶
遗臭万年	流芳百世||万古长存||一代风流||豹死留皮||名垂青史||永垂不朽
喜气洋洋	愁眉锁眼||愁眉苦脸
惊涛骇浪	风平浪静
撒	收
瘦	肥
有口皆碑	民怨沸腾||人言可畏||不足挂齿||怨声载道
主食	副食
故人	新交
引咎自责	以邻为壑
资本主义	社会主义
洋洋洒洒	味同嚼蜡||简明扼要
以直报怨	忘恩负义
旁观	参与||介入
呼天抢地	前仰后合
立足之地	无地自容||无处容身
吸引力	推斥力
大恩大德	新仇旧恨||小恩小惠||血海深仇
野无遗才	藏龙卧虎
不由自主	独立自主
斜纹	平纹
年深日久	瞬息之间||一朝一夕
不容置疑	无稽之谈||荒诞不经
专制	民主
贱	贵
顶	底
残破	完好||完整
打草惊蛇	欲擒故纵
折本	盈利
不屈不挠	卑躬屈膝
繁花似锦	残枝败柳
褒	贬
旁门	正门
畏首畏尾	敢想敢干||披荆斩棘||万死不辞||无所畏惧||自告奋勇||当机立断||豪放不羁||无所顾忌||义无反顾
甘心情愿	身不由己||迫不得已
面熟	面生
伯仲之间	天渊之别
随便	拘谨
匆猝	从容
峰回路转	山穷水尽
缺吃少穿	丰衣足食
弃若敝屣	敝帚千金||爱不释手
防不胜防	料事如神||万无一失
去火	上火
微型	大型
物极必反	千篇一律
弹压	安抚
坐商	行商
白驹过隙	度日如年
损人利己	舍己为人||为渊驱鱼
高明	低劣
强硬	和缓||软弱
络绎不绝	七零八落
复圆	初亏
热烈	冷淡||平静||冷清
抵制	支持
屈	直
好事多磨	一帆风顺
再生父母	血海深仇||切骨之仇
酒肉朋友	布衣之交||金兰之契||患难之交
别开生面	家常便饭||述而不作||规行矩步
空口无凭	立此存照||铁证如山
忠心耿耿	大逆不道||惹草拈花
达官	平民
令人齿冷	肃然起敬
女	男
心慈手软	心狠手辣||杀气腾腾||心狠手毒
完整	残缺||破碎
各行其是	遥相呼应||步调一致
西历	农历
称誉	申斥
秘密	公开
惊魂未定	从容不迫
偏听偏信	持平之论||中庸之道
泥沙俱下	沙里淘金||去伪存真
岁月蹉跎	马不停蹄
一介不取	一网打尽
逆	顺
素雅	俗气
纳税	免税
心无二用	魂不守舍||一心二用||三心二意
先锋	后卫
变本加厉	大题小作||微不足道
耗费	节省
削职为民	走马上任
轻视	重视||注重
散失	收藏
激进	保守
偷香窃玉	循规蹈矩||安分守己
明察暗访	不见薪新
一干二净	邋里邋遢
开源节流	铺张浪费
自负	谦虚
拨乱反正	积重难返||每况愈下||离经背道
饥寒交迫	饱食暖衣||金迷纸醉||人寿年丰||丰衣足食||暖衣饱食
边缘	中心||中央
滋生	灭绝
悲天悯人	随遇而安||自得其乐
见怪不怪	惊心动魄
欲壑难填	一尘不染
画蛇添足	歪打正着||弄假成真
学名	乳名
不辞而别	不速之客
宝	废
围城打援	围魏救赵
七拼八凑	无懈可击||浑然一体
胡说八道	言之有据
落后	领先||发达||进步
势不两立	唇齿相依||情同骨肉||情投意合||相得益彰||并行不悖||三位一体
头重脚轻	根深蒂固
悲剧	喜剧
年轻力壮	年老力衰
喽罗	头目
空谈快意	现身说法
喜笑颜开	愁肠百结||如丧考妣||忧心忡忡
守节	失节
沮丧	高兴||兴奋
补偿	损耗
平行	交叉
花前月下	行同陌路
具体	抽象||概括
的了吗呢	之乎者也
游手好闲	埋头苦干||夙兴夜寐||孜孜不倦
忘记	记得
刮目相看	不屑一顾||视如草芥||置之不理
鸦默雀静	沸反盈天
羞怯	大方
诅咒	颂扬||祝福
不成体统	循规蹈矩
迫在眉睫	远在天边||慢条斯理
固体	流体||液体
冷锋	暖锋
言行一致	言行不一||口不应心
支出	收入
家给人足	嗷嗷待哺||家破人亡||艰难竭蹶||啼饥号寒||家贫如洗||日前月腹
叠床架屋	精兵简政||删繁就简
原告	被告
平缓	险峻||峭拔
雄厚	薄弱
见利思义	见利忘义||利令智昏
有勇无谋	大智大勇||智勇双全||有勇有谋
雨季	旱季
扶	抑
动工	竣工
锦上添花	雪中送炭||佛头着粪
开胃	反胃
开诚布公	勾心斗角||难言之隐||掩耳盗铃||尔虞我诈||明枪暗箭
变幻莫测	一成不变||木已成舟||依然如故
万事亨通	艰难曲折||荆棘载途||时乖命蹇||焦头烂额||内外交困
鬼头鬼脑	光明正大||堂堂正正
播种	收获
酒囊饭袋	能工巧匠
莫名其妙	洞若观火||一清二楚
奔走相告	呆若木鸡||面如土色
前脚	后脚
狭路相逢	风云际会||天作之合||康庄大道
粗鲁	文雅
低沉	高亢
流体	固体
闹嚷嚷	静悄悄
大巧若拙	愚不可及
断	续||连
君	臣
出超	入超
干巴	水灵
持久战	速决战
视为畏途	奋不顾身
朴实大方	花枝招展
乐音	噪音
里通外国	大义灭亲
就地取材	他山之石
抑扬顿挫	平铺直叙
每况愈下	百废俱兴||气象万千||盛极一时||欣欣向荣||与日俱增||拨乱反正||有加无已
暮霭	晨曦
冷气	暖气
丧心病狂	心平气和||平心静气
孤立无援	一呼百诺||里应外合
菩萨心肠	如狼似虎||心狠手辣
朝气	暮气
水火不容	物以类聚||形影不离
享乐	吃苦
一年生	多年生
楚楚可怜	令人作呕||望而生畏
东山再起	冰消瓦解||一蹶不振
放晴	转阴
多年生	一年生
租	佃
独树一帜	如法炮制
束之高阁	爱不释手||掌上明珠
寸步难行	畅通无阻||如鱼得水||轻而易举
八拜之交	一日之雅
离	合||就
明	暗||幽
脱口而出	守口如瓶
人间	地狱
锦绣前程	穷途末路
良好	恶劣||低劣
天真烂漫	呆头呆脑||老成持重||矫揉造作
龙行虎步	卑躬屈膝||低三下四
一统天下	一盘散沙||四分五裂
英姿飒爽	獐头鼠目
拙见	高见
去	留||回
防微杜渐	江心补漏
落网	漏网||潜逃
落叶归根	乐不思蜀
若有所失	不动声色||若无其事||自我陶醉||聊以自慰||悠然自得
真话	谎话
慌里慌张	慢条斯理
排泄	吸收
陡坡	慢坡
起碇	抛锚
肤皮潦草	严肃认真
东鳞西爪	包罗万象||原原本本||浑然一体
尽职	失职
循序渐进	揠苗助长||一步登天
下贱	高贵
复学	休学
身陷囹圄	重见天日
不经之谈	不刊之论||不易之论
米珠薪桂	物美价廉
获得	失去
悬崖勒马	执迷不悟||死皮赖脸
沿袭	改革
防患未然	猝不及防||临阵磨枪||放任自流||亡羊补牢
婉转	直率||直爽
一官半职	黎民百姓||父老兄弟
意味深长	索然无味||索然无味
实质	现象
东倒西歪	井井有条
良久	俄顷||片刻
手足之情	反目成仇||视同陌路
故弄玄虚	实事求是
刁难	成全
有	无||没
无凭无据	信而有征
暗码	明码
全力以赴	敷衍了事||三心二意
石沉大海	一封家书||死灰复燃
不堪一击	固若金汤||坚如磐石||举世无敌||无坚不摧||壁垒森严
奥妙无穷	一定之规
以强凌弱	除暴安良||抑强扶弱
万紫千红	枯木朽株||一花独放
不在话下	鞭长莫及||大书特书
牧工	牧主
江郎才尽	初露锋芒||下笔成章
启碇	抛锚
屈打成招	不打自招||宁死不屈||铁案如山
缠身	脱身
暖气	冷气
功	过
哭	笑
马革裹尸	临阵脱逃
动荡	安稳||安定
知情达理	胡搅蛮缠
满载而归	宝山空回||空手而回
接受	拒绝||递交||给予
开荤	吃素
慈善	凶恶
横行霸道	打躬作揖||安分守己||奉公守法
和好	反目
勉为其难	游刃有余
保密	泄密
仰视观察	盲人摸象
众口交谪	拍案叫绝
如意算盘	南柯一梦
实践	空谈
凤冠霞帔	荆钗布裙||鹑衣百结
青梅竹马	背信弃义
出现	消失||消逝||隐没||隐藏
潜	浮
席丰履厚	餐风露宿
废弃	使用
高瞻远瞩	苟且偷安||急功近利||目光如豆||鼠目寸光||急公近利||井蛙之见||杀鸡取卵
三长两短	安然无恙
凡庸	杰出
黎民百姓	一官半职
揠苗助长	放任自流||循序渐进
靠天吃饭	人定胜天
良师益友	一丘之貉||狐群狗党
方寸已乱	心安理得
四平八稳	操之过急||如饥似渴||轻举妄动||想入非非
扶老携幼	奸淫掳掠
旰食宵衣	好逸恶劳
静止	运动||移动
贫乏	丰富||富足
特意	顺便
横行无忌	安分守己
臣	君
起身	到达
吃素	吃荤||开荤
生灵涂炭	国泰民安
三纲五常	离经叛道
食肉寝皮	情深义重||一往情深
手舞足蹈	闷闷不乐||不苟言笑
无所用心	惨淡经营||费尽心机||煞费苦心||搜索枯肠||有所作为||事必躬亲||挖空心思
对口	单口
俊	丑
始终不懈	虎头蛇尾
处之泰然	操之过急||惶恐不安||惊恐万状||不可终日||诚惶诚恐
各自为政	同心协力||遥相呼应
以貌取人	任人唯贤
沉寂	喧闹
非分	本分
是非分明	不分青红皂白||不问青红皂白||颠倒是非||青红皂白||一丘之貉||倒打一耙||混淆是非
珠光宝气	荆钗布裙||质朴无华
浮动	固定
敬佩	鄙夷||鄙视
失信	取信||守信
液体	固体
坦诚相见	假人假义
人山人海	人迹罕至||寥寥无几
廉洁奉公	寡廉鲜耻||无耻之尤
挨肩擦背	敬而远之
沉陷	突起
投机取巧	正人君子
坚定	游移||动摇||犹疑||犹豫
平民	贵族||达官
退化	进化
荼毒	爱护
坚不可摧	摧枯拉朽||毁于一旦||一触即溃
温故知新	数典忘祖
束手就擒	垂死挣扎||绝处逢生||负隅顽抗
往日	来日
扩充	裁并
不辞辛劳	四体不勤，五谷不分||好逸恶劳
直爽	婉转
防守	攻打||进攻
亘古不变	瞬息万变
西	东
崇拜	蔑视
童叟无欺	欺人太甚||买空卖空
救命之恩	深仇大恨
原文	译文
一呼百诺	孤掌难鸣||孤立无援
偶然	必然
脱颖而出	怀才不遇
本来面目	耸人听闻||装模作样||乔装打扮||涂脂抹粉
出言不逊	彬彬有礼||温柔敦厚||谦厚有礼
群威群胆	孤家寡人
颠簸	平稳
冲动	冷静
视而不见	过目不忘
发热	发冷
平安无事	狼烟四起
三思而行	轻举妄动||意气用事||不假思索
丧权辱国	光宗耀祖
湖光山色	穷山恶水
丰裕	贫困
弯路	捷径
当世无双	无独有偶
得寸进尺	进寸退尺||心满意足||适可而止
剑拔弩张	绵里藏针||销兵洗甲
排遣	郁结
收缩	膨胀
槁木死灰	生气勃勃
一朝一夕	匪伊朝夕||年深日久||日久天长||长年累月||久而久之||穷年累月||通宵达旦
才疏学浅	博学多才||才高行洁||经天纬地||真才实学||才气过人||高八斗
麻木不仁	神经过敏||严阵以待||受宠若惊
因势利导	听其自然||听之任之
潜移默化	无动于衷
徒有虚名	名不虚传
秀色可餐	其貌不扬
残害	保护||保卫
骑虎难下	无往不利||势如破竹
星散	云集
斯文扫地	显亲扬名
愁容	笑容
召回	派遣
力图	力避
富足	贫乏
自觉自愿	逼上梁山
覆灭	生还
结草衔环	以德报怨||忘恩负义
励精图治	祸国殃民
守口如瓶	冲口而出||说长道短||脱口而出||口若悬河||说东道西
含辛茹苦	无忧无虑||养尊处优
自私自利	毁家纾难||济困扶危
无所顾忌	畏首畏尾
阳历	阴历
成事	败事
扫尾	起头
外子	内子
兴奋	抑制||镇静||忧愁
大同小异	迥然不同||大相径庭
轻巧	笨重
慢坡	陡坡
豪华居室	穴居野处
孤军深入	里应外合
兢兢业业	草草了事||敷衍塞责||敷衍了事
空手而回	满载而归
自然人	法人
违背	遵从
不可逾越	后来居上
玩忽职守	以身殉职||克尽厥职
收复	沦丧
惊慌	镇静||沉着
匪伊朝夕	一朝一夕
决一死战	不分胜负
侮辱	尊重
遥相呼应	各行其是||各自为政
理所当然	荒谬绝伦
赤地千里	繁荣富强||郁郁葱葱||蓊蓊郁郁
色彩单一	五光十色||五颜六色
言必有据	妄下雌黄
初出茅庐	老成持重||老谋深算||久经世故||识途老马
颠沛流离	安家落户||安家立业
便利	麻烦
荷枪实弹	手无寸铁||赤手空拳
他人	自己
强头倔脑	唯唯诺诺
有害	有用
车载斗量	寥若晨星
噩耗	喜讯||佳音
却之不恭	置之不理
失宜	适宜
碌碌无能	出类拔萃||大有可为||大显身手
放诞	检点
敷衍塞责	殚精竭虑||兢兢业业||尽心竭力||匹夫有责
凯旋	败北
冷	热||暖
蓬头垢面	眉清目秀||风仪秀整
匕鬯不惊	兵匪不分
俯拾即是	凤毛麟角||千载一时
弱	强
忘性	记性
外强中干	外圆内方||外柔内刚
养兵	用兵
反复无常	始终不渝||一去不复返
众	寡
啧有烦言	交口称誉||众口交誉||口碑载道
粗制滥造	精耕细作||精益求精||千锤百炼||精妙绝伦||呕心沥血
烜赫一时	彪炳千古
卓见	浅见
执拗	随和
小处着手	大处着眼
贫瘠	肥沃
赏罚不当	赏罚分明
不露锋芒	锋芒毕露
治病救人	致人死地||落井下石
绿林好汉	打家劫舍
白头如新	相见恨晚
漫不经心	全神贯注||聚精会神||专心致志
千钧一发	安如磐石||安然无恙||稳如泰山
离心离德	群策群力||同心同德||众星捧月||戮力同心
强弩之末	势如破竹||势不可挡
歪打正着	画蛇添足
改头换面	庐山真面目||原封不动||依然如故
精确	粗略||约略
难于登天	举手之劳||易如反掌
闲	忙
一丝一毫	成千累万
齐心协力	貌合神离
弹指之间	日久天长||千秋万代
气馁	骄傲
相机行事	生搬硬套
欲盖弥彰	文过饰非||相得益彰
指挥若定	心中无数
深仇大恨	救命之恩||恩重如山
和风细雨	暴风骤雨||急风暴雨||令行禁止||凄风苦雨||咄咄逼人||劈头盖脸
厚此薄彼	一视同仁
荣华富贵	倾家荡产
谙练	生疏
骄慢	谦虚
生日	忌日
夙兴夜寐	游手好闲||饱食终日
少许	大量
美	丑
冷酷无情	儿女情长
目迷五色	漆黑一团||明察秋毫
毅然决然	优柔寡断
不省人事	耳聪目明||通情达理
贫穷	富有||富饶||富庶||富裕
丰盛	短缺
销帐	入帐||上帐
虚与委蛇	真诚相待||推心置腹||真心实意
一无是处	完美无缺||十全十美||未可厚非
枯燥无味	津津有味||耐人寻味
例行公事	别出心裁
沽名钓誉	实至名归
合并	划分
荒地	熟地
安家立业	颠沛流离||流离失所||萍踪浪迹||沦落风尘||无家无业
潦草	工整
不乏先例	下不为例
别有风味	如出一辙||千篇一律
牢固	薄弱||松散
看押	释放
典雅	粗俗
亏空	盈利||结余
奖	惩
欠帐	还帐
趁火打劫	扶危济困||见义勇为||除暴安良||抚危济贫
孤陋寡闻	博闻强识||知多见广||见多识广
对牛弹琴	对症下药||有的放矢
齐	乱
拙	巧
灵敏	迟钝
不问青红皂白	泾渭分明||是非分明
赎身	卖身
皂	白
博大精深	不学无术||以蠡测海
威风凛凛	丑态百出||文质彬彬
信手拈来	来之不易||大海捞针
炫玉贾石	心口如一
死路一条	前程万里||死里逃生
三位一体	势不两立
粪土	瑰宝
土崩瓦解	安如泰山||坚如磐石||固若金汤
弱不禁风	身强力壮||虎背熊腰||心宽体胖
一暴十寒	锲而不舍||持之以恒
青面獠牙	和颜悦色||明眸皓齿||慈眉善目||绝代佳人
下限	上限
遥遥相对	毫无瓜葛||互不相干
锐不可当	铩羽而归||损兵折将
庸庸碌碌	雄才大略
国步艰难	国泰民安||国富民强
晴	阴
实	空||名||虚
摆脱	依附
纳降	投降
无理取闹	不由分说||善罢干休||据理力争||息事宁人
权门	寒门
理直气壮	理屈词穷||无地自容||强词夺理
爱好	厌恶
风马牛不相及	唇齿相依
招降纳叛	选贤任能||吐故纳新
全面	片面
超然物外	随波逐流||投身其中
背信弃义	骨肉相连||青梅竹马||一诺千金||恪守不渝
奇形怪状	司空见惯
民困国贫	繁荣富强
盛开	凋谢
忧	乐
天翻地覆	一成不变
老翁	少年
侵占	退赔
势如冰炭	情同手足
兼容并包	爬梳剔抉
郊区	城市
剩余	缺少
漫长	短暂
粗心大意	精打细算||小心翼翼||小心谨慎
反胃	开胃
畅通无阻	寸步难行
淡忘	惦记
甘居下游	力争上游
盛	衰
详细	简单||简略
难能可贵	不足为奇
次要	主要
流食	普食
本金	利息
一路顺风	跋山涉水
盈	亏
一曝十寒	日积月累||好学不倦
自转	公转
背叛	归顺||归降
离休	在职
行之有效	海底捞月||劳而无功||徒劳无益||以卵投石||海底捞针||无济于事||与虎谋皮
长此以往	一时半刻
揭竿而起	忍辱偷生
无功受禄	按劳分配||一无所得||论功行赏
锋利	和缓||锐利||滞钝||迟钝
穷形尽相	平铺直叙
竹头木屑	奇珍异宝
变化无穷	原封不动
朝秦暮楚	始终不渝||一往情深||始终如一
鼠目寸光	大开眼界||鉴往知来||神通广大||高瞻远瞩||料事如神
金蝉脱壳	瓮中捉鳖
乘虚而入	无隙可乘||坐失良机
点金成铁	点铁成金
长寿	短命
一知半解	打破沙锅问到底
智者千虑	愚者千虑，必有一得
徒劳无功	不劳而获||一本万利
信	疑
大名鼎鼎	无名鼠辈||臭名昭著
豹死留皮	遗臭万年
欺贫爱富	惜老怜贫
将来	过去
普食	流食
发家致富	倾家荡产
发冷	发热
稳操胜券	一筹莫展||心中有数
实话	空话
出口	进口
天涯海角	一箭之遥||咫尺之间||近在咫尺
无关大局	举足轻重||燃眉之急
冰消瓦解	重起炉灶||东山再起
少安毋躁	心急如焚
有头无尾	绳锯木断||原原本本||来龙去脉||自始至终
一箭双雕	事倍功半
怨气冲天	心平气和
愤时嫉俗	随遇而安
作	息
妄自尊大	顾影自怜||三顾茅庐||望洋兴叹||自轻自贱||不矜不伐||妄自菲薄||自暴自弃
杀一儆百	宽大为怀||既往不咎||以一警百
称心如意	大失所望||事与愿违
三人成虎	眼见为实
兴师	回师
失散	团圆||欢聚
后继有人	后继乏人||接二连三||后继无人||青黄不接
杀身成仁	苟且偷生
唾手可得	大海捞针||千载难逢
神	人||形
有始有终	有始无终
堆金积玉	阮囊羞涩||绳床瓦灶
敬而远之	攀龙附凤||相敬如宾||挨肩擦背||亲密无间
寒来暑往	度日如年
管窥蠡测	洞若观火
闭口不言	振振有词||畅所欲言
暗送秋波	明目张胆
名声扫地	身价百倍
呆头呆脑	七步之才||天真烂漫||眼明手快
今不如昔	昔不如今||今非昔比
低眉顺眼	昂首挺胸
乱成一团	丝丝入扣
忠言逆耳	甜言蜜语||花言巧语
行家	外行
万籁俱寂	沸沸扬扬||锣鼓喧天||天崩地裂||震耳欲聋||惊天动地||熙来攘往
破旧	崭新
卑鄙无耻	高风亮节
久经世故	初出茅庐
真率	做作
同归于尽	贪生怕死
领受	谢绝
皆大欢喜	怨声载道||大失所望
自然	做作||法人||造作
挂虑	放心
贼眉贼眼	秀外慧中
骄阳似火	天寒地冻
许愿	还愿
不堪入耳	娓娓动听||珠圆玉润||余音绕梁
延长	缩短
鸡虫得失	锱铢必较||斤斤计较
水涨船高	一成不变
徒手	持械
一时半刻	长此以往
云消雾散	云笼雾锁
平声	仄声
苍白	红润
相亲相爱	反目成仇
养痈贻患	养军千日，用在一时
自强不息	自暴自弃||自轻自贱
干	亲||群||湿
挑拨	功和||说和
人言可畏	口碑载道||有口皆碑
见贤思齐	见利忘义||争风吃醋
世态炎凉	一如既往
陪音	基音
定	退
皈依	脱离
竭泽而渔	从长计议
哭笑不得	落落大方||泰然处之
牵强	贴切
养痈遗患	不留余地||斩尽杀绝
显现	隐没
惊天动地	万籁俱寂||不知不觉
乐不思蜀	恋恋不舍||落叶归根
无独有偶	独一无二||举世无双||当世无双
险峻	平缓
出家	还俗
毫无疑义	大有可疑||满腹疑团
单干	合作
忍辱负重	忍无可忍
抵达	起程
超龄	适龄
炮火连天	河清海晏
文治	武功
熟地	荒地
井底之蛙	见多识广
专横跋扈	彬彬有礼||谦谦君子
坚持不懈	半途而废||三天打鱼，两天晒网||浅尝辄止
敝帚千金	弃若敝屣
捣乱	安分
言不及义	言必有中
忸怩	大方
提心吊胆	逍遥自在||高枕无忧
勇而无谋	有勇有谋
费尽心机	无所用心
借债	还债
踌躇满志	灰心丧气||垂头丧气
拼	拆
小康之家	富商巨贾||豪门大族
层出不穷	寥若晨星||寥寥无几
只专不红	又红又专
籴	粜
多才多艺	不学无术
开宗明义	旁敲侧击
苦难	幸福
安定	动荡||动乱||骚动
朝阳	夕阳
不刊之论	不经之谈||似是而非||无稽之谈
冬	夏
不可收拾	蒸蒸日上||旭日东升
粗疏	精细
处心积虑	心血来潮
水	陆||山
啼	笑
言而有信	言而无信
痴呆	伶俐
追本求源	舍本逐末
相提并论	一分为二
喷薄欲出	日薄西山
孱弱	强壮||壮实
绝唱	败笔
植党营私	招贤纳士
花言巧语	忠言逆耳
气宇轩昂	垂头丧气
偶	奇||独
四大皆空	酸甜苦辣||七情六欲
通过	阻塞
披荆斩棘	畏首畏尾||瞻前顾后
参加	退出
无依无靠	大有靠山||有人撑腰
赞同	反驳
年终	年初
爱	恨
存	亡
好	恶||歹||坏||糟
千载难逢	屡见不鲜||唾手可得||习以为常
掩鼻而过	蜂拥而至
哀鸿遍野	普天同庆
戕害	爱护
连篇累牍	断简残编||片言只字||三言两语||惜墨如金||片言只语
现身说法	空谈快意
慷慨	吝啬||悭吝
席不暇暖	无所事事
放马后炮	先入之见
孤军作战	招兵买马
近在咫尺	不远千里||地角天涯||山南海北||天各一方||天涯海角
天花乱坠	平铺直叙
出头露面	深居简出||隐姓埋名||销声匿迹
夜郎自大	妄自菲薄
正牌儿	杂牌儿
楚囚对泣	谈笑自若||败而不馁
复会	休会
家破人亡	家给人足||安居乐业||太平盛世
笑逐颜开	愁眉苦脸||泪如雨下||忧心忡忡||哀毁骨立||疾首蹙额
转危为安	得而复失
家贫如洗	家财万贯||家给人足||富丽堂皇
分崩离析	不可开交||坚如磐石
投井下石	雪中送炭
动人心弦	黯然失色||平淡无奇
恒河沙数	沧海一粟||屈指可数||寥若晨星
独辟蹊径	拾人牙慧||鹦鹉学舌
谈笑自若	惶恐不安||谈虎色变||张皇失措||楚囚对泣
黔驴技穷	三头六臂||力大无穷
要价	还价
千虑一失	千虑一得
儿女情长	冷酷无情
朝	夕||野||暮
简	繁
博闻强记	不学无术
声	韵
无效	有效
不自量力	量才录用||量力而行
欢聚一堂	妻离子散
劳而无功	劳苦功高||行之有效
卖劲	偷懒
松懈	紧张
健康长寿	香消玉殒
捷报频传	节节败退||杳如黄鹤
鹏程万里	走投无路
新硎初试	饱经风霜
不以为然	顶礼膜拜||五体投地||仰承鼻息
动摇	稳固
真心实意	虚与委蛇
高价	低价
欢乐	悲哀||哀伤||愁苦
丑态百出	威风凛凛||婀娜多姿
血气方刚	暮气沉沉
远大	短浅
一目了然	错综复杂||管中窥豹||千头万绪||若隐若现||雾里看花||不可捉摸||高深莫测||迷离恍惚||若明若暗
汗颜无地	恬不知耻
老手	生手
汗流浃背	滴水成冰||冰天雪地
顺差	逆差
发现	埋没
何乐不为	死不瞑目
奸猾	忠厚
来之不易	轻而易举||易如反掌||信手拈来
两点论	一点论
登记	注销
不欢而散	济济一堂
烦琐	简明
兴味索然	津津乐道||妙不可言||兴致勃勃
序幕	尾声
朝不虑夕	高枕无忧
金榜题名	榜上无名||名落孙山
刺眼	顺眼
合而为一	分而为二
年老力衰	年轻力壮
竖立	放倒
无所畏惧	不寒而栗||谨小慎微||望而生畏||畏葸不前||胆小如鼠||投鼠忌器||畏首畏尾
关闭	起动||敞开||开启
有名无实	名副其实||实事求是||名实相副
炯炯有神	模糊不清||黯然无光
错综复杂	井然有序||一目了然
任命	撤职||放弃
必要劳动	剩余劳动
古代	现代
荦荦大端	鸡毛蒜皮||鸡零狗碎
大处着眼	斤斤计较||小处着手
困难至极	顺手牵羊
颠倒是非	是非分明||实事求是
销声匿迹	出头露面||死灰复燃
触目皆是	铁树开花
正人君子	酒色之徒||人面兽心||鼠窃狗盗||跳梁小丑||歪门邪道||投机取巧||寻花问柳
苟且偷生	成仁取义||前仆后继||舍生取义||宁死不屈||杀身成仁
地角天涯	近在咫尺
百花齐放	残花败柳||一花独放
弃甲丢盔	所向披靡||马到成功
生吞活剥	融会贯通||一笔抹煞
厚古薄今	厚今薄古
厄运	幸运||好运
气壮山河	气息奄奄
稠密	稀疏||寥落||稀少
强壮	虚弱||孱弱
单眼	复眼
临危不惧	不寒而栗||临阵脱逃||惊慌失措||如临大敌
惊慌失措	临危不惧||稳如泰山||从容不迫||神色自若
不可救药	起死回生
寥若晨星	车载斗量||恒河沙数||星罗棋布||层出不穷
一盘散沙	万众一心||众志成城||济济一堂||一统天下
官官相护	刚正不阿||赏罚分明
贪得无厌	两袖清风||一尘不染
静如处女	动如脱兔
事半功倍	舍近求远||剜肉补疮
预赛	决赛
轻侮	恭敬
言而无信	君子一言，快马一鞭||信誓旦旦||言而有信||一言既出，驷马难追||说一不二||言传身教
俯仰由人	独当一面
留	去
骨肉相连	众叛亲离||背信弃义
破镜难圆	百年之好
感激涕零	恩将仇报||无动于衷
生离死别	破镜重圆
过目成诵	熟视无睹
卑鄙	高尚
波动	稳定
昙花一现	不可磨灭||万古长青
亡国之音	哀而不伤
分化瓦解	戮力同心||精诚团结
傲然屹立	摇摇欲坠
草本	木本
真相	假象
心宽体胖	弱不禁风
开诚相见	勾心斗角||假仁假义
权宜之计	长久之计
顺眼	刺眼
辞退	聘请
收入	支出
名行其事	通力合作
出世	去世
无比欢欣	苦不堪言
行时	过时
故乡	异乡
旭日东升	不可收拾||日薄西山||夕阳西下
骚人墨客	胸无点墨
风雨同舟	过河拆桥
显而易见	模棱两可||图穷匕见
虚拟	真实
平淡无奇	悲欢离合||出神入化||动人心弦||绘声绘色||奇花异草||诗情画意||无奇不有||呼之欲出||生花妙笔||数一数二||异乎寻常
固执己见	人云亦云||耳软心活
划清	混淆
麻麻黑	麻麻亮
明朗	昏暗||灰暗||阴沉
门可罗雀	高官厚禄||熙熙攘攘||车水马龙
拘捕	释放
千里之行，始于足下	好高骛远
惊恐万状	不动声色||处之泰然
鳞次栉比	杂乱无章||参差不齐
卓有成效	鲜有成效||无济于事
包庇	检举||告发
生手	老手||熟手
有目无睹	有目共睹
修理	损坏
不留余地	养痈成患||养痈遗患
公	母||私
早点	夜＃
前仰后合	饮泣吞声||呼天抢地
必然王国	自由王国
毁于一旦	坚不可摧
想方设法	无计可施
平和	剧烈
千秋万代	弹指之间||指日可待||一年半载
谦虚谨慎	居功自傲||盛气凌人||忘其所以||自吹自擂||骄傲自满||狂妄自大||趾高气扬
一本正经	不伦不类||油腔滑调||嬉皮笑脸||油嘴滑舌
榫头	卯眼
寸步不离	不即不离
府上	舍下
言传身教	言而无信
寻根究底	不求甚解
怒	喜
粜	籴
寄人篱下	白手起家||自食其力||自力更生
痛改前非	不思悔改||积重难返||铸成大错
万壑千岩	一马平川
书面	口头
敝帚自珍	视如草芥||在所不惜
不打自招	居心叵测||屈打成招
玉帛	干戈
挥霍无度	节衣缩食||日积月累||断齑画粥||克勤克俭
有神论	无神论
狐疑不决	当机立断
寝食不安	心安理得||泰然处之
如坐春风	如临大敌
君子一言，快马一鞭	言而无信
息息相通	不相往来||漠不关心
叶公好龙	名副其实||名实相符
悲伤	高兴||愉快
高洁	卑污||鄙污
介入	旁观
刻骨铭心	过眼烟云||浮光掠影
边陲	内地
合作	分工||单干
虚	实
老马识途	不知所以||少不更事||暗中摸索
直不笼统	曲里拐弯
爱称	憎称
不知所云	出口成章
声援	申讨
荏	厉
风靡一时	久盛不衰
微乎其微	扣人心弦||磬竹难书||举足轻重||硕大无朋
夸大	缩小
暗	明
敌意	善意
嘘寒问暖	漠不关心
实学	虚名
片言只字	累牍连篇||连篇累牍
众叛亲离	百川归海||笼络人心||骨肉相连||人心所向
神思恍惚	泰然处之
芬芳	腐臭
不可企及	青出于蓝||后来居上
硕果仅存	比比皆是
缺点	优点
望文生义	精益求精||字斟句酌||融会贯通
嬉笑	怒骂
隐恶扬善	红口白牙
扣人心弦	微乎其微||无动于衷
沾沾自喜	愁肠百结||灰心丧气||垂头丧气
起航	停航||返航
甜丝丝	苦咧咧
优游自在	疲于奔命
确凿无疑	无中生有
咸	淡
模本	摹本
空缺	满额
瘦小	高大||肥大
吠影吠声	针锋相对
佛头着粪	锦上添花
功德无量	恶贯满盈||罪大恶极
公诸同好	秘而不宣
宝物	废物
不一而足	屈指可数
朝不保夕	安然无恙||高枕无忧
阳	阴
暗淡	明亮
身教	言教
暧昧不明	爱憎分明
原由	结果
质	量
安谧	热闹||嘈杂
嫡系	旁系||旁支
戮力同心	离心离德||分化瓦解
暗无天日	光天化日||重见天日||枯木逢春||阳光普照
减弱	增强
切磋琢磨	不求甚解||浅尝辄止||不相为谋
乞降	受降
虚情假意	深情厚意||实心实意
鸿篇巨制	言简意赅||片言之语
高谈阔论	沉默寡言||一言不发
壁垒森严	不堪一击||一触即溃
不可或缺	多此一举
继日成功	付诸东流
粉墨登场	消声匿迹||匿影藏形
不堪入目	赏心悦目
一定之规	奥妙无穷||不时之需
马马虎虎	一丝不苟||认认真真
白班	夜班
无风起浪	息事宁人
偃武修文	兵荒马乱
人烟稠密	地旷人稀||十室九空||荒无人烟
匀速运动	变速运动
得心应手	不文不武||力不胜任||事与愿违||束手无策||无能为力||身不由己
神气活现	奴颜婢膝||不耻下问
浮躁	沉着
丧尽天良	大慈大悲
死	生||活
文科	理科
严阵以待	麻痹大意||一张一弛||麻木不仁
罢官	复职
赤日炎炎	天寒地冻
生	师||死||卒||熟
窗明几净	满屋尘灰
非同小可	无足轻重||区区小事
深不可测	真相大白
宁为玉碎，不为瓦全	忍气吞声||苟且偷安
缠绵	解脱
报国	叛国
一寸光阴一寸金	蹉跎岁月
灯火阑珊	万家灯火
明察秋毫	目迷五色
同病相怜	幸灾乐祸||同床异梦
褒扬	批评
城下之盟	自食其力||自强自力
轻车简从	前呼后拥
和蔼可亲	穷凶极恶||正颜厉色||气势汹汹
相对无言	说三道四||谈笑风生
助纣为虐	除暴安良||为民除害
小题大作	大题小作||等闲视之
妇孺皆知	鲜为人知
后脚	前脚
无所不包	一无所有||一贫如洗
杂	纯
悲哀	欢乐||高兴
寿终正寝	一息尚存||寿比南山
严密	松散
适当	失当
索然无味	百读不厌||耐人寻味||回味无穷||意味深长
不恤人言	谨言慎行
纯熟	生疏
娘家	婆家
苟且偷安	发愤图强||宁为玉碎，不为瓦全||高瞻远瞩
空气污染	沁人心脾
不吝指教	骄傲自满
天干	地支
夜阑人静	鸡犬不宁||人声鼎沸
塌陷	隆起
热泪盈眶	眉开眼笑||笑容可掬
罪过	功劳
抱头鼠窜	得胜班师
晚上	早晨
手足无措	措置裕如||神色自若||慢条斯理||镇定自若
按捺	放纵
白昼	黑夜
当面	背后
自尊自爱	自掘坟墓
认帐	赖帐
信而有征	无凭无据||信口开河
有声有色	无声无息
藕断丝连	丁一卯二||丁是丁，卯是卯
聊以自慰	若有所失
本位	全局
迎刃而解	相持不下||治丝益棼
自我陶醉	若有所失
急中生智	无计可施
抗税	上税
春暖花开	天寒地冻
罗唆	简练
小令	长调
铁石心肠	恻隐之心||牵肠挂肚||百感交集||心慈面软
相形见绌	出人头地
地久天长	喜新厌旧
固若金汤	土崩瓦解||不堪一击
珍惜	糟踏||浪费
曙光	暮色
透彻	浮浅
人云亦云	固执己见
艰辛	安适
瓮中捉鳖	缘木求鱼||金蝉脱壳
一日千里	慢条斯理
信口开河	信而有征||引经据典||三缄其口||言之凿凿
聪明伶俐	蠢如鹿豕
不速之客	不辞而别
吃亏	划算
暗中摸索	老马识途
淋漓尽致	理屈词穷||轻描淡写
厌弃	喜爱
虚假	真实||确实
良	劣||莠
虚心好学	师心自用
残花败柳	姹紫嫣红||百花齐放
巨富	赤贫
凤毛麟角	俯拾即是
之乎者也	的了吗呢
开张	停业
向隅而泣	春风得意||得意忘形
当机立断	当断不断||举棋不定||畏首畏尾||犹豫不决||筑室道谋||狐疑不决||游移不决
人强马壮	人仰马翻||残兵败将
沙文主义	国际主义
推波助澜	随波逐流||息事宁人
产	销
富庶	贫穷
如愿以偿	难偿所愿||适得其反||事与愿违
错落不齐	错落有致
匮乏	丰富
瑜不掩霞	瑕不掩瑜
百思莫解	豁然开朗
尸位素餐	克勤克俭||分秒必争
天壤悬隔	相差无几
时乖命蹇	吉祥如意||万事亨通||加官进爵
康庄大道	歪风邪气||狭路相逢||坎坷不平||歪门邪道
确信不疑	胡思乱想
弃	拾
同	异||殊
违	奉
虎背熊腰	弱不禁风||肌瘦如柴
罪有应得	罚不当罪
无济于事	立竿见影||行之有效
内政	外交
手忙脚乱	从容不迫||有条不紊||行若无事
递增	递减
感人肺腑	无动于衷
内忧外患	国泰民安
眉开眼笑	愁眉不展||捶胸顿足||叫苦不迭||泪如雨下||热泪盈眶||椎心泣血||叫苦连天||怒目而视||涕泗滂沱
偏重	并重
豁然开朗	百思莫解||如堕烟海
澄清	搅混||混淆||搅浑
司空见惯	百年不遇||大惊小怪||见所未见||奇形怪状||前所未闻||前无古人||闻所未闻||触目惊心||盖世无双||绝无仅有||晴天霹雳||千载难逢
侵吞	退赔
错落有致	杂乱无章||错落不齐||乱无章
指日可待	千秋万代||杳无音信||遥遥无期
花样翻新	老调重弹
榜上无名	榜上有名||金榜题名
无的放矢	百步穿杨||弹无虚发||箭不虚发||对症下药
正大光明	鬼鬼祟祟||偷天换日||心怀鬼胎||偷偷摸摸||心怀叵测
贵	贱
记	忘
中间	两头
初露锋芒	大器晚成||江郎才尽
井蛙之见	高瞻远瞩
无伤大雅	损伤根本
惊心动魄	见怪不怪
延缓	提前
一面之词	兼听则明
反感	好感
通亮	黢黑
祸不单行	洪福齐天||吉星高照||双喜临门
摹本	模本
万劫不复	卷土重来
迅速	缓慢||迟缓
大显身手	碌碌无能||小试锋芒
保护	损害||残害||摧残||破坏
陈陈相因	革故鼎新
黑灯瞎火	灯火辉煌
青黄不接	后继有人
出乖露丑	绰约多姿
忙	闲
心平气和	暴跳如雷||愤愤不平||恼羞成怒||七窍生烟||气冲斗牛||气急败坏||气势汹汹||杀气腾腾||怨气冲天||火冒三丈||怒不可遏||其势汹汹||气喘吁吁||丧心病狂||喜怒哀乐
豁然贯通	大惑不解
精	粗
不假思索	慢条斯理||三思而行||左思右想||深思熟虑
粗鄙	高雅
夜以继日	蹉跎岁月
无声无息	举世闻名||鸣锣开道||声势浩大||震天动地||鸣锣喝道||如火如荼||有声有色
酒足饭饱	食不果腹
扶摇直上	急转直下
一言堂	群言堂
人去楼空	久居故里
牵肠挂肚	置于脑后||铁石心肠
老人	小孩
粗重	尖细
风驰电掣	蜗行牛步
嗷嗷待哺	丰衣足食||家给人足
华丽	朴素||质朴
严惩	宽贷
自由民	奴隶
参差不齐	鳞次栉比||整齐划一
精挑细选	寻章摘句
旋乾转坤	回天乏术
主犯	从犯
力求	力避
瘟神	傩神
盗名欺世	忠诚老实||实事求是
耳提面命	旁敲侧击
奢侈	简朴||勤俭
仆人	主人
优柔寡断	兵贵神速||决断如流||斩钉截铁||毅然决然
崎岖	平坦
沁人心脾	令人作呕||空气污染
真相大白	深不可测||真伪莫辨||不白之冤
日久天长	一朝一夕||弹指之间
切肤之痛	无关痛痒||不关痛痒
母本	父本
易懂	费解
肃然起敬	漠然置之||令人齿冷
台上	台下
有始无终	善始善终||有始有终||持之以恒
风云人物	无名小卒
暴利	薄利
艳	素
憎恨	热爱
枯木逢春	暗无天日
死而无憾	抱恨终天
公物	私产
就职	辞职
贬黜	晋升
人迹罕至	人山人海
失约	践约
违天悖理	仗义执言
势合形离	貌合神离
屋上架屋	精兵简政
人面兽心	正人君子
漏洞百出	百无一失||十拿九稳||滴水不漏||天衣无缝
外	内
奴颜媚骨	一寸丹心||威武不屈
爱抚	虐待
辣手	顺手
封闭	打开
忠言	谗言
自卑感	优越感
绝无仅有	多如牛毛||举不胜举||司空见惯||泛滥成灾||三番五次
避重就轻	知难而进||避实击虚
盛夏	隆冬
血流飘杵	兵不血刃
心中无数	心中有数||胸中有数||胸有成竹||指挥若定
画地为牢	任其驰骋||豪放不羁
前门	后门
奴仆	主人
干枯	水灵
牢不可破	溃不成军||不绝如缕
泄露	保守
百发百中	百不一存
涂脂抹粉	本来面目
有机可乘	无机可乘||无懈可击||无隙可乘
心旷神怡	心慌意乱||心如火焚
袖手旁观	挺身而出
黯然无光	金碧辉煌
挥金如土	断齑画粥||爱财如命||一毛不拔
胸中有数	心中无数
倾巢而出	按兵不动
待理不理	满腔热情
附和	反驳
万象更新	万古不变||依然如故||一切如故
安家落户	颠沛流离||南征北战
祸灭九族	封妻荫子
忠君爱国	乱臣贼子
松弛	紧张
上行下效	源清流洁
万古长青	昙花一现
身败名裂	功成名遂||名满天下
不思悔改	闭门思过||痛改前非
深恶痛绝	老牛舐犊||小鸟依人||爱不释手
务实	务虚
单刀直入	拐弯抹角||借题发挥||旁敲侧击
各得其所	人浮于事
好处	坏处||害处
侃侃而谈	支吾其词||噤若寒蝉||沉默寡言
后来居上	不可企及||望尘莫及||不可逾越
不择食	挑肥拣瘦
见多识广	孤陋寡闻||少见多怪||井底之蛙||一孔之见
五体投地	不以为然
蛟龙得水	怀才不遇||蛟龙失水
贪赃枉法	法不阿贵||公正无私||两袖清风||清正廉明||奉公守法||明镜高悬
除旧布新	蹈常袭故||因循守旧||率由旧章
血流成河	兵不血刃
刻骨仇恨	以德报怨
差强人意	大失所望
起早贪黑	无所事事
夸夸其谈	三缄其口
一唱三叹	驴鸣狗吠
德才兼备	残渣余孽||德薄能鲜||德薄才疏
一步登天	循序渐进||一落千丈||行远自迩||一蹶不振
手无寸铁	荷枪实弹
正凶	帮凶
小样	大样
观点	材料
隐晦曲折	开门见山||直言不讳||深入浅出
慌手慌脚	稳如泰山
清洁	肮脏||污浊
污七八糟	井井有条||井然有序
振振有辞	理屈词穷||哑口无言
真知灼见	一得之见||一隅之见||老生常谈
唯物史观	唯心史观
蓬门荜户	雕梁画栋||书香门第||朱门大户
源源不断	断断续续||弹尽粮绝
不拘一格	如出一辙
道不同不相为谋	志同道合
救死扶伤	落井下石||杀人如麻
行远自迩	一步登天
白面书生	花花公子||彪形大汉
地大物博	弹丸之地
磨砺以须	临阵磨刀
天下为公	天下为家
浪迹天涯	归去来兮||归心似箭
碌碌无为	大有可为||精明强干||前程万里
以蠡测海	博大精深||兼收并蓄
陡	平
天罗地网	逃之夭夭
尊贵	低＃
先睹为快	后发制人
破坏	保护||建设
以眼还眼，以牙还牙	退避三舍
捧腹大笑	泪如泉涌
投鼠忌器	无所畏惧
说长道短	一言不发||守口如瓶
机关用尽	束手无策
降表	战书
治标	治本
后继乏人	后继有人
歪风邪气	康庄大道
行	止
配房	正房
灾祸	喜庆
无中生有	铁证如山||确凿无疑
谈笑风生	不苟言笑||相对无言
束手无策	兵来将挡，水来土掩||得心应手||机关用尽||千方百计||如臂使指||神通广大||大刀阔斧||机关算尽||情急智生||神机妙算
得意忘形	怅然若失||向隅而泣
按部就班	急于求成||勇往直前||闻风而动
切骨之仇	再生父母
磬竹难书	微乎其微
宽厚	刻薄
喊冤叫屈	委曲求全
操之过急	处之泰然||措置裕如||四平八稳||水磨工夫
目光如炬	目光如豆
始终不渝	朝秦暮楚||反复无常||情随事迁||见异思迁
愁肠百结	洋洋得意||喜笑颜开||沾沾自喜
凸	凹
师心自用	不耻下问||虚心好学
置之度外	耿耿于怀
卷土重来	偃旗息鼓||万劫不复
专程	顺道
俗不可耐	雅人深致
天差地别	毫厘不爽||势均力敌||旗鼓相当
喜闻乐见	惨不忍闻||痛恨不已
假	真
有勇有谋	有勇无谋||勇而无谋
无所不知	一窍不通||一无所知
闭目塞听	耳聪目明||耳闻目睹||眼观六路
排难解纷	拨弄是非
异乎寻常	平淡无奇
不可磨灭	昙花一现
改过自新	死不改悔||顽固不化
众口一词	众说纷纭
班师回朝	调兵遣将||安营扎寨
乐而忘返	乐极生悲
壮实	孱弱
丰功伟绩	奇耻大辱||弥天大罪||一得之功
低声下气	呼幺喝六||不卑不亢||气冲牛斗
退隐	出仕
谦厚有礼	出言不逊||出口伤人
稳扎稳打	轻举妄动
结集	分散
公理	谬论
排除万难	瞻前顾后
外敌	内奸
轻率	慎重
无声无臭	举世闻名
大地回春	冰天雪地
晚	早
隔热	导热
喜庆	灾祸
镇静	兴奋||惊慌||慌乱
古音	今音
一穷二白	人给家足||丰衣足食
照本宣科	断章取义
人才零落	人才济济
显达	卑微
盛极一时	一落千丈||每况愈下
始	终
再版	初版
客观	主观
明镜高悬	贪赃枉法
放下屠刀，立地成佛	死不改悔
鹦鹉学舌	独辟蹊径
秉公执法	徇私枉法
奸贼死党	钦差大臣
源远流长	无本之木||无源之水
足不出户	走南闯北
茹苦含辛	如解倒悬
洋洋大观	微不足道
平纹	斜纹
毛利	净利
祛邪	扶正
先斩后奏	事先请示
勇冠三军	畏敌如虎
大度包容	睚眦必报||小肚鸡肠
古为今用	以古非今
左右逢源	内外交困||望眼欲穿||左支右绌||左右为难
五黄六月	十冬腊月
荒诞不经	不容置疑
事关全局	无关痛痒
披肝沥胆	尔虞我诈||勾心斗角
高枕无忧	朝不保夕||大敌当前||人人自危||枕戈待旦||朝不虑夕||枕戈寝甲
脱脂	全脂
胸无点墨	博学多才||骚人墨客||八斗之才||著作等身
明晰	模糊
融会贯通	生搬硬套||望文生义||穿凿附会||生吞活剥
视同儿戏	小心翼翼
爱怜	厌恶
后代	前辈
冷飕飕	热烘烘
血海深仇	大恩大德||再生父母||恩重如山
乘风破浪	裹足不前
一寸丹心	狼心狗肺||奴颜媚骨
举世瞩目	默默无闻
轻于鸿毛	举足轻重||重于泰山
坐失良机	乘虚而入||分秒必争||趁热打铁
谢天谢地	怨声载道
去伪存真	泥沙俱下||鱼龙混杂
豆蔻年华	不惑之年
如临大敌	临危不惧||如坐春风
来日方长	日薄西山||事不宜迟||急不可待||日暮途穷
新伙伴	老搭当||老搭档
生存	死亡
稠人广众	人烟稀少
危险	安全
依依不舍	一刀两断
晕厥	苏醒
革故鼎新	抱残守缺||因循守旧||陈陈相因||泥古不化
今非昔比	今不如昔
积极	消极
默默无言	声嘶力竭
回头是岸	咎由自取||怙恶不悛||执迷不悟
五湖四海	方寸之地
出口伤人	谦厚有礼
奋勇当先	畏缩不前
倒	正
坏	好
风吹浪打	风平浪静
曚昽	明亮
脱险	遇险
目空一切	虚怀若谷||妄自菲薄
泰山	鸿毛
与人为善	嫁祸于人||六亲不认||杀人不见血||欺人太甚
大义灭亲	徇情枉法||里通外国
指雁为羹	巧妇难为无米之炊
七手八脚	有条不紊
亲政	摄政
知错改错	一误再误
精疲力竭	精力充沛
荆棘载途	万事亨通||金光大道
泣不成声	欢天喜地||笑容可掬
支2	主
怅然若失	得意忘形
有隙可乘	无隙可乘
鹤立鸡群	滥竽充数
道路以目	敢说敢做
巩固	削弱
热乎乎	冷冰冰
兴妖作怪	风平浪静
读书无用	开卷有益
投机倒把	生财有道||生财之道
喜眉笑脸	愁眉苦脸
澄澈	混浊
屏弃	吸收
替身	正身
劳燕分飞	鸾翔凤集
大失所望	称心如意||皆大欢喜||正中下怀||差强人意||尽如人意
山穷水尽	方便之门||峰回路转||柳暗花明
深度	广度
人生如寄	人寿年丰
学而不厌	骄傲自满||好为人师
饿	饱
吉星高照	祸不单行||生不逢时||凶多吉少
小心谨慎	粗心大意||矜才使气
收回	发出||付出
省吃俭用	大手大脚||铺张浪费
喜事	丧事
板	活
应接不暇	应付裕如
捕风捉影	确凿不移
鱼米之乡	不毛之地||穷山恶水||龙潭虎穴
勃谿	和睦
趑趄不前	勇往直前||一往无前
无源之水	源远流长
珍宝	草芥
夺	送
该	还
死里逃生	死路一条
全	偏
商港	军港
因小失大	一举两得
应时	过时
要言不繁	大块文章
舍近求远	事半功倍
漫山遍野	寥寥无几
有闻必录	充耳不闻||听而不闻
天作之合	乱点鸳鸯||仇人相见||狭路相逢
龙潭虎穴	鱼米之乡||洞天福地
真嗓	假嗓
瞬息万变	停滞不前||亘古不变
仓促	从容
云蒸霞蔚	暗淡无光||漆黑一团
分门别类	同日而语
分析	综合
好转	恶化
既往不咎	杀一儆百||信赏必罚
义正辞严	理屈辞穷
改过迁善	顽固不化
形销骨立	脑满肠肥
收押	释放
西洋画	中国画
随心所欲	设身处地||循规蹈矩||谨小慎微||缩手缩脚
乳名	大名||学名
承认	否认||否定
根基深厚	白手起家
无关宏旨	举足轻重||至关紧要
格律诗	自由诗
忽视	重视
不识抬举	感恩戴德
大雨如注	雨过天青
居功自傲	谦虚谨慎||功成不居
厢房	正房
大名	乳名
淡泊明志	争权夺利
菲薄	丰厚||优厚
感恩图报	恩将仇报||忘恩负义
空空荡荡	满满当当
天造地设	牵强附会||矫柔造作
集装	散装
进退失据	进退有常||进退中绳
沸点	冰点
口若悬河	缄口结舌||钳口不言||守口如瓶||钳口结舌||三缄其口
见财起意	路不拾遗
饿虎扑食	龙困浅滩
一张一弛	严阵以待
疮痍满目	锦绣河山||琳琅满目
晚霞	早霞||朝阳
装聋作哑	振聋发聩
井井有条	百废待举||东倒西歪||七零八落||污七八糟||杂乱无章||纵横交错
顾此失彼	面面俱到
刺耳	顺耳
不露声色	大张旗鼓||情不自禁
浮漂	塌实
不欺暗室	暗室欺心
祥瑞	凶兆
玩世不恭	谨小慎微
百废不举	百废俱兴
丢盔卸甲	横扫千军||旗开得胜
突然袭击	先礼后兵
三令五申	敷衍了事
棋高一着	棋逢对手
轮种	连种
出口成章	佶屈聱牙||语无伦次||不知所云
败诉	胜诉
笔译	口译
助桀为虐	除暴安良||助人为乐
怜香惜玉	喜新厌旧||煮鹤焚琴
一落千丈	青云直上||一步登天||盛极一时
赤胆忠心	心怀叵测||口是心非
殚精竭虑	敷衍塞责
独自	结伴
赚	赔
春兰秋菊	半斤八两
放纵	管束||按捺||克制||收敛
神仙	凡人
月末	月初
踌躇	果断
何去何从	听天由命
其乐无穷	悲不自胜
意料之中	不期而然||从天而降
手下留情	执法如山||毫不留情
见缝插针	针插不入||水泼不进
光明正大	城狐社鼠||鬼头鬼脑||偷鸡摸狗||阴谋诡计||鬼鬼祟祟||含沙射影
惜墨如金	拖泥带水||连篇累牍
开水	生水
滥竽充数	鹤立鸡群||名副其实||出类拔萃||货真价实||宁缺毋滥
杳无音信	指日可待||空谷传声
清苦	阔绰
解毒	中毒
缺陷	优点
身经百战	坐而论道||纸上谈兵
举世无敌	一触即溃||不堪一击
如饥似渴	不慌不忙||四平八稳
张皇失措	谈笑自若||若无其事
庄重	轻佻
恭顺	跋扈
钳口结舌	口若悬河||直言不讳
事后	事前
随机应变	胶柱鼓瑟||一成不变
挂牵	放心
邀请	应邀
开启	关闭
无产阶级	资产阶级
庞然大物	微不足道||小巧玲珑
力不能支	力挽狂澜||力所能及
倾家荡产	发家致富||荣华富贵||成家立业
无恶不作	秋毫无犯||乐善好施
蜂拥而入	破门而出
浓厚	稀薄
害群之马	仁人志士||谦谦君子
切中事理	痴人说梦||痴心妄想
刻薄	宽厚||厚道
世外桃源	人间地狱
惶恐不安	处之泰然||谈笑自若
声色犬马	流芳百世
洋洋得意	愁肠百结||黯然销魂
分秒必争	尸位素餐||坐失良机||蹉跎岁月||因循坐误
缺少	充足||富余||剩余
压抑	发挥||扶植||放纵
武功	文治
众说纷纭	异口同声||众口一词
路不拾遗	浑水摸鱼||巧取豪夺||见财起意
如日中天	桑榆暮景||日薄西山
西学	中学
心力交瘁	神采奕奕
斗筲之材	栋梁之材
借贷	偿还
胶柱鼓瑟	通达权变||随机应变
恰到好处	过犹不及||矫枉过正
奴	主
非亲非故	沾亲带故
如解倒悬	茹苦含辛
快活	忧愁||忧伤
不教而诛	仁至义尽||谆谆教诲
话中有话	直言不讳
违犯	遵守
心血来潮	处心积虑
当众	背＃
耳闻不如目见	道听途说
扦格不通	酣畅淋漓
心劳日拙	欣欣向荣||蒸蒸日上
喜剧	悲剧
发愤图强	苟且偷安
忍俊不禁	强颜欢笑
败仗	胜仗
荆天棘地	光天化日
显著	细微
见风使舵	一成不变
不甘寂寞	不闻不问||默默无闻
提倡	制止
浑身是胆	胆小如鼠
天伦之乐	孤苦伶仃||看破红尘
冷若冰霜	宾至如归||满腔热情||温情脉脉
满腔热情	冷若冰霜||待理不理
大慈大悲	穷凶极恶||罪不容诛||丧尽天良
波澜壮阔	一潭死水
谬误	真理
抓紧	放松
夸富	哭穷
声色俱厉	不动声色
简括	详尽
求贤若渴	嫉贤妒能
有形	无形
洪大	细小
一脉相承	以讹传讹
闻风而动	按部就班
衣锦夜行	衣锦还乡
高人一等	低人一等||低三下四
得不偿失	乞浆得酒||一举两得
樗栎庸材	才华出众
吸收	排泄||屏弃
姗姗来迟	捷足先登||争先恐后
无名英雄	赫赫有名
自吹自擂	实事求是||谦虚谨慎
卵生	胎生
奉若神明	视如敝屣
投身其中	超然物外
誓不两立	亲密无间
笑	啼||哭
幽	明
愁	喜||乐
关	开
下马看花	蜻蜓点水||走马看花||走马观花
装腔作势	落落大方
知法犯法	遵纪守法
怨声载道	歌功颂德||口碑载道||人心所向||有口皆碑||皆大欢喜||普天同庆||谢天谢地||众口交颂
漠然置之	体贴入微||肃然起敬||油然而生
逢	别
副	正
惹草拈花	忠心耿耿
英雄好汉	无名小卒
绝口不道	津津乐道
适龄	超龄
令人神往	令人作呕
多此一举	必不可少||不可或缺
敏捷	笨拙||迟缓
杯盘狼藉	井然有序
孤掌难鸣	一呼百诺||众志成城||众擎易举
引力	斥力
后知后觉	先知先觉
唯心论	唯物论
闻过则喜	知错不改||拒谏饰非||文过饰非
窥豹一斑	巨细无遗
当仁不让	临阵脱逃||推三阻四
九牛二虎之力	举手投足
便当	麻烦
舒畅	沉郁||难受
黢黑	雪白||通亮
娓娓动听	一言不语||不堪入耳
数典忘祖	饮水思源||温故知新
命中注定	祸福无门
服役	退伍
手到病除	病入膏肓
海底捞月	立杆见影||行之有效
名实相副	有名无实||名不副实
收拢	放开
丑声远播	名垂千古
南	北
师	生
无视	重视
一蹴而就	欲速则不达
民怨沸腾	有口皆碑||大快人心
抢购	抛售
语重心长	浮光掠影||轻描淡写
坚忍不拔	摇摆不定||举棋不定
目不识丁	满腹经纶||学富五车
冥顽不灵	聪明才智||聪明睿智||茅塞顿开||大器晚成
殊	同
尾	头
独创	抄袭
发扬蹈厉	无精打采
嘉许	贬斥
生不逢时	福如东海||吉星高照||三生有幸||吉人天相||时来运转
煞费苦心	无所用心||掉以轻心
是	非
阶下囚	座上宾
赤手空拳	荷枪实弹||全副武装||兵强马壮||坚甲利兵
起死回生	不可救药
实事求是	盗名欺世||颠倒是非||故弄玄虚||哗众取宠||巧立名目||添枝加叶||先入为主||有名无实||自吹自擂||颠倒黑白||断章取义||好高骛远||弄虚作假||添油加醋||招摇撞骗
糊涂	明白
息事宁人	播弄是非||推波助澜||无理取闹||无风起浪
木已成舟	变幻莫测
制定	取消
吉祥如意	时乖命蹇||多灾多难
心不在焉	聚精会神||屏气凝神||专心致志||乐此不疲||全神贯注
朔月	望月
光芒万丈	漆黑一团
天灾人祸	喜从天降
治	乱
釜底抽薪	沸汤沸止||扬汤止沸||火上浇油
含冤负屈	雷打不动||委曲求全
如火如荼	无声无息
秋毫无犯	鸡犬不留||无恶不作||胡作非为||巧取豪夺
天南地北	望衡对宇
朝气蓬勃	老气横秋||死气沉沉||萎靡不振
千头万绪	洞若观火||有条不紊||一目了然
马首是瞻	南辕北辙||背道而驰
不合时宜	因时制宜
恐慌	镇定
骨瘦如柴	肥头大耳||脑满肠肥||心广体胖||大腹便便||身强力壮
绳之以法	逍遥法外
成群结队	踽踽独行||孑然一身
挥洒自如	东扶西倒
风吹雨打	风平浪静||风和日丽
推荐	自荐
凶狠	善良
鄙污	高洁
断交	建交
万死不辞	贪生怕死||畏首畏尾
草芥	珍宝
整整齐齐	乱七八糟||犬牙交错
毛手毛脚	小心翼翼||认认真真
神色不动	神魂颠倒
黯然销魂	洋洋得意||心花怒放||怡然自得
人寿年丰	人生如寄||饥寒交迫||水深火热
震天动地	无声无息
战胜	战败
冤家路窄	风云际会||失之交臂||旧雨重逢
从宽发落	执法如山
仓皇失措	镇定自若||从容不迫
英雄豪杰	无名小卒
争斗	和解
末	本
文恬武嬉	文治武功
知难而进	避重就轻||知难而退||急流勇退
入情入理	不近人情
伶牙俐齿	顿口拙腮
爱不释手	弃若敝屣||深恶痛绝||束之高阁
抵足而眠	同床异梦||貌合神离
旺盛	衰退
死亡	生存
建交	断交||绝交
坚贞不屈	奴颜婢膝
甚嚣尘上	风平浪静
和蔼	粗暴||蛮横
天下大乱	天下太平
贪官污吏	清正廉明
摧残	保护
无瑕可击	贻人口实
专心致志	见异思迁||漫不经心||心不在焉||三心二意
将错就错	将功补过||知过必改||过而能改||截长补短
任人唯贤	任人唯亲||以貌取人
艰难曲折	万事大吉||万事亨通
卸装	上装||化装
沸腾	平静||沉寂
贫苦	富有
臭名远扬	金字招牌||名扬四海
哀兵必胜	骄兵必败
老调重弹	花样翻新||不破不立
饮鸩止渴	从长计议
斥力	引力||吸力
昂贵	低廉
内奸	外敌
淤塞	疏通||疏浚
有备无患	江心补漏||临渴掘井
释	捕
下达	上报
兴风作浪	相安无事
仪态万方	其貌不扬||面目可憎
渐变	突变
身不由己	得心应手||应付自如||甘心情愿
通畅	堵塞
爱惜	糟蹋||糟践
身价百倍	名声扫地
数不胜数	寥寥无几
丑	美||俊
低	高
反面无情	深情厚谊
弃明投暗	弃暗投明
生死存亡	安如泰山
上水	下水
肮脏	干净||洁净||清洁
空	满||实
莫逆之交	素昧平生
狂妄自大	谦虚谨慎||频频入礼
背井离乡	安土重迁
变数	常数
痴人说梦	切中事理||循规蹈矩
泛滥成灾	绝无仅有
结实	单弱
直直溜溜	歪歪扭扭
过而能改	将错就错
默不做声	说三道四||大声疾呼
拆台	捧场
热爱	憎恨
人稠物穰	人杰地灵
受奖	受罚
雷厉风行	按兵不动
心如火焚	心旷神怡
行将就木	蒸蒸日上
鸡飞蛋打	一举两得
群英荟萃	狐群狗党
精妙绝伦	粗制滥造
展望	回顾
意译	直译
人无完人	求全责备
悉听尊便	强人所难
庸医杀人	妙手回春
内	外
睡	醒
拥护	反对
广阔天地	立锥之地
细	粗
离经背道	拨乱反正
措置裕如	操之过急||手足无措
底	顶
盾	矛
功亏一篑	善始善终
怀才不遇	丹凤朝阳||蛟龙得水||脱颖而出
心慈面软	铁石心肠||心狠手辣
家常便饭	别开生面||山珍海味
顺理成章	牵强附会||颠三倒四||语无伦次
讨厌	喜欢||喜爱
秣马厉兵	刀枪入库
望衡对宇	天南地北||千里迢迢
增高	减低
谈何容易	垂手可得||一挥而就
血债累累	恩深义厚
昏天黑地	灯火辉煌||历历在目||历历可数
堵塞	疏通||疏导||通畅||畅通
视同路人	一见如故||攀龙附凤
间日	每日
索取	退还||奉献
死不甘心	心甘情愿
个性	共性
化名	真名
文弱书生	赳赳武夫
深情厚意	虚情假意
气愤	高兴
正身	替身
虚张声势	不动声色
动用	储存
疾首蹙额	笑逐颜开
罪不容诛	大慈大悲
恶贯满盈	功德无量
一团乱麻	丝丝入扣
祸从口出	谨言慎行||喜从天降
坐而论道	身经百战||事必躬亲
难	易
宽	窄
风流云散	风起云涌||三五成群||风云际会
组装	拆散
出神入化	平淡无奇
双喜临门	祸不单行
谆谆	藐藐
故步自封	日新月异||一往无前||取长补短||勇往直前
收盘	开盘
言必有中	有口无心||言不及义
不痛不痒	死去活来||一针见血||一语中的
归田	出仕
福星	灾星
余	亏
淡然处之	认认真真||勇往直前
清正廉明	贪官污吏||贪赃枉法
老态龙钟	鹤发童颜||年富力强
肘腋之患	疥癣之疾
无所作为	大有作为||任重道远||知难而退
歃血为盟	口血未干
奖赏	处罚
年富力强	老态龙钟||弱不胜衣
劳方	资方
僧徒	俗人
八面玲珑	刚直不阿||心口如一
众所周知	一无所知
脏	净
强迫	自愿
若即若离	亲密无间||水乳交融
逸	劳
多元论	一元论
遵纪守法	知法犯法
在朝	在野
礼尚往来	来而不往
风云际会	风流云散||冤家路窄||狭路相逢
不毛之地	极乐世界||鱼米之乡
举措不当	恰如其分
在野	执政||在朝
寸土必争	拱手相让
烟波浩渺	风平浪静
一模一样	截然不同
免职	任用||起用
滚瓜烂熟	吞吞吐吐
重归于好	旧愁新恨
名正言顺	理屈词穷||师出无名
诚实	虚伪||狡猾||说谎
公费	私费
略见一斑	一览无遗
时过境迁	一如既往||记忆犹新
沉默寡言	刺刺不休||津津乐道||贫嘴薄舌||七嘴八舌||高谈阔论||呶呶不休
南征北战	安家落户
绝交	建交||通好
取长补短	故步自封
以卵投石	行之有效
烟消云散	烟雾弥漫
宽绰	狭窄||局促
浓重	稀薄
神出鬼没	按兵不动
答非所问	对答如流
公正无私	贪赃枉法
面黄肌瘦	大腹便便||容光焕发
降志辱身	平反昭雪
健旺	衰老
轻而易举	寸步难行||难如登天||铁树开花||插翅难飞||来之不易
先入为主	实事求是
振聋发聩	装聋作哑
高慢	谦逊
光润	粗糙
大功告成	功败垂成||前功尽弃
屈服	反抗
长久	暂时||暂短
恪守不渝	背信弃义
责无旁贷	置身事外||推三阻四
满腹经纶	目不识丁
欢送	欢＃||欢迎
求和	求战||求胜
冲锋陷阵	望风而逃
说东道西	守口如瓶
无意识	有意识
三十六计，走为上计	坐以待毙
志士仁人	跳梁小丑||魑魅魍魉
笨头笨脑	心明眼亮
行商	坐商
满满当当	空空荡荡
早衰	早熟
心如铁石	喜形于色
桀骜不驯	俯首帖耳||唯命是从||俯首听命
支离破碎	浑然一体||完美无缺||完璧归赵
垂死挣扎	束手就擒||束手待毙
蓊蓊郁郁	赤地千里
捉襟见肘	绰绰有余||游刃有余
一尘不染	贪得无厌||欲壑难填||糖衣炮弹
油腻	清淡
反唇相讥	无言以对
雪上加霜	如虎添翼
糟践	爱惜
置若罔闻	耿耿于怀
坦诚相待	假仁假义
一塌糊涂	井然有序
前线	后方
重见天日	身陷囹圄||暗无天日
醉生梦死	枕戈待旦
蒙受	洗雪
争风吃醋	见贤思齐||男欢女爱
公益	私利
不相上下	黯然失色||天差地远||无与伦比||迥然不同||无可比拟
从容不迫	仓皇失措||急如星火||惊慌失措||狼狈不堪||目瞪口呆||手忙脚乱||心烦意乱||心急火燎||惊魂未定||面面相觑
坦荡如砥	悬崖峭壁
旧愁新恨	重归于好
落落大方	哭笑不得||煞有介事||搔头弄姿||装腔作势
开卷	闭卷
闭关自守	对外开放||救亡图存
恢复	断绝
清官	赃官||墨吏
一孔之见	持平之论||见多识广
铺张	节俭
熙熙攘攘	门前冷落||门可罗雀||冷冷清清||冷冷清清
钟爱	憎恶
恩重如山	深仇大恨||血海深仇||绝情寡义
一潭死水	波澜壮阔
一无所得	无功受禄
寡言少语	千叮万嘱
亲如手足	不共戴天
甜美	苦恼
颂扬	诽谤||诅咒
半路出家	驾轻就熟||炉火纯青||训练有素||科班出身
刁钻古怪	平易近人||朴素大方
输入	输出
做贼心虚	若无其事
大显神通	无能为力||一筹莫展
扶摇直下	急转直下
铺天盖地	蜻蜓点水
红灯	绿灯
先天不足	得天独厚
凶相毕露	一团和气
哀而不伤	哀毁骨立||亡国之音
十室九空	人烟稠密||安居乐业
判若两人	一如既往||半斤八两
提纲挈领	不得要领||轻重倒置
有头有尾	虎头蛇尾
朴素大方	刁钻古怪
莫明其妙	洞若观火
小恩小惠	大恩大德
铜墙铁壁	无坚不摧
川流不息	水泄不通
临阵脱逃	当仁不让||马革裹尸||临危不惧||前赴后继
人给家足	一穷二白
拍案而起	悠然自得
高僧	沙弥
盈余	亏损
急匆匆	慢腾腾
雕心雁爪	冰壶秋月
枯鱼之肆	绝处逢生
谦称	尊称
可恨	可爱
志大才疏	才高意广
壮健	瘦弱
适可而止	得寸进尺||多多益善||过犹不及
兵荒马乱	偃武修文
阿谀奉承	刚正不阿
谨言慎行	不恤人言||祸从口出||为非作歹||轻举妄动
枯萎	繁盛||葱茏||丰美||茂盛||旺盛
博闻强识	不学无术||孤陋寡闻
肝肠寸断	乐不可支||心花怒放
损公肥私	公而忘私||毁家纾难||舍己为公
沸反盈天	鸦默雀静||鸦雀无声
心怀天下	独善其身
安土重迁	背井离乡||戎马倥偬||志在四方||离乡背井
悲不自胜	其乐无穷
凝练	冗长
万不得已	心甘情愿
前程万里	碌碌无为||死路一条||日暮途穷
夕	朝||旦
平起平坐	截然不同
圆	方
谜底	谜面
领	发
后手	先手
声势浩大	无声无息
应有尽有	一无所有||空空如也
完美无缺	白璧微瑕||金无足赤，人无完人||瑕瑜互见||一无可取||支离破碎||一鳞半爪||一无是处
无以复加	人外有人
斩草除根	姑息养奸||养虎遗患||贻害无穷||后患无穷
斩钉截铁	拖泥带水||犹豫不决||优柔寡断
国内	海外
复古	革新
气息奄奄	气贯长虹||气壮山河||生气勃勃||大气磅礴||气吞山河
社会主义	资本主义
自相鱼肉	生死与共
势不可挡	强弩之末
神通广大	黔驴之计||束手无策||鼠目寸光||梧鼠技穷
消逝	出现
布衣之交	酒肉朋友
母音	子音
争光	丢丑
弥散	聚集
以守为攻	以攻为守
颗粒无收	五谷丰登
满面春风	愁眉苦脸||愁眉不展
望	朔
祸国殃民	安邦定国||忧国忧民||励精图治
力避	力图||力求
谆谆教诲	不教而诛
快马加鞭	老牛破车
义务	权利
嘉言懿行	为非作歹
物以类聚	水火不容||格格不入
大放厥词	缄口结舌
进退中绳	进退失据
周到	疏忽
礼贤下士	居高临下||盛气凌人
昔不如今	今不如昔
顽固不化	不经一事，不长一智||改过自新||脱胎换骨||改过迁善||悔之无及||洗心革面
妙手回春	庸医杀人||病入膏肓
入赘	出嫁
点播	条播
势成骑虎	如臂使指||一帆风顺
毛骨悚然	镇定自若
痛哭流涕	喜出望外||哑然失笑
借	还
容许	禁止
选集	全集
过失	成绩
熟识	陌生||生疏
揭穿	掩盖
弥天大罪	丰功伟绩
上升	下降||跌落
鱼龙混杂	黑白分明||去伪存真
一见如故	视同路人||行同陌路||素不相识
重蹈覆辙	吃一堑，长一智||前车之鉴||他山之石||前车可鉴
肆无忌惮	规行矩步||循规蹈矩
践约	失约||负约
爽利	拖沓
置于脑后	牵肠挂肚
纹丝不动	闻风而起
沧海桑田	一成不变
耐人寻味	枯燥无味||索然无味
毒辣	仁慈
你死我活	生死与共||同生共死
从长计议	仓促行事||急于求成||饮鸩止渴||竭泽而渔
无情无义	深情厚谊
淡季	旺季
前	后
添	减
其貌不扬	国色天香||眉目如画||千娇百媚||秀色可餐||仪态万方||花容月貌||一表人才
顽皮	老实
欢迎	欢送
日理万机	无所事事||斗鸡走狗
自命不凡	自惭形秽||甘拜下风
不尽人情	人之常情
不分皂白	黑白分明
引吭高歌	浅酌低吟
草草了事	一丝不苟||兢兢业业
断章取义	实事求是||照本宣科
丧命	获救
穷困潦倒	平步青云||财运亨通
不屑一顾	垂涎三尺||举足轻重||刮目相看
陈词滥调	言简意赅
仇人相见	天作之合
见异思迁	山盟海誓||始终不渝||忠贞不渝||矢志不渝||一心一意||专心致志
熄灭	燃烧
前所未有	史不绝书
群策群力	单刀赴会||独断专行||朋比为奸||离心离德||一手包办
患得患失	宠辱不惊||公而忘私||大公无私
别出心裁	如法炮制||例行公事
敢想敢干	谨小慎微||畏首畏尾
在劫难逃	鸿运高照
才高意广	志大才疏
麻烦	简便||便当||便利||方便
待机而动	迫不及待
弹冠相庆	如丧考妣
密切	疏远
大彻大悟	鬼迷心窍
成人之美	乱点鸳鸯||落井下石||成人之恶
醇厚	淡薄
以退为进	突飞猛进
旧雨	新朋
一字千金	一文不值
置信	置疑
卑微	显赫||显达
经	纬
冷漠	热情||热心
正本清源	脚痛医脚
独步天下	狐假虎威
临阵磨枪	防患未然
量才录用	不自量力||一视同仁
勤快	懒惰
广度	深度
跑龙套	唱主角
普渡众生	六亲不认
久盛不衰	风靡一时
条播	点播
枕戈寝甲	高枕无忧
煞笔	起笔
大逆不道	三从四德||唯命是从||忠心耿耿
臭味相投	格格不入||意气相投
一挥而就	谈何容易
喜怒无常	一成不变||温文尔雅
恍惚	清醒
矢志不渝	见异思迁||朝三暮四
纯净	混浊||污浊
浓艳	素淡
天寒地冻	春光明媚||春色满园||赤日炎炎||春暖花开||骄阳似火
垂手可得	谈何容易||海底捞针
灰心丧气	意气扬扬||踌躇满志||沾沾自喜
久而久之	一朝一夕
新月	残月
云笼雾锁	云消雾散
难分难解	天各一方
悲观	乐观
左思右想	不假思索
分道扬镳	白头偕老||济济一堂||如胶如漆||志同道合
还愿	许愿
四通八达	穷途末路
世风日下	蒸蒸日上
矜才使气	胆小如鼠||小心谨慎
人心所向	众叛亲离||怨声载道
懦夫	勇士
不共戴天	亲同手足||亲密无间||亲如手足
如泣如诉	慷慨悲歌
随声附和	独具匠心
敌对	友好
肥沃	贫瘠
可憎	可爱
三头六臂	一无所长||黔驴技穷
细枝末节	举足轻重
接连不断	断断续续||史无前例
洞天福地	龙潭虎穴||穷巷拙门
人浮于事	各得其所
不卑不亢	低声下气||俯首听命||委曲求全||俯首贴耳
海底捞针	垂手可得||行之有效||叹为观止
吸力	斥力
弃甲曳兵	所向披靡
应付裕如	应接不暇
急急忙忙	慢慢腾腾
后门	前门
两袖清风	贪得无厌||诛求无已||贪赃枉法
返航	起航
摘要	全文
自掘坟墓	自尊自爱
逼上梁山	自觉自愿
青天白日	半夜三更
长	幼||短
心如刀割	欣喜若狂||欢天喜地
凉	热||炎||暖||温
六神无主	镇静自若||若无其事
深厚	淡薄
元旦	除夕
臭烘烘	香喷喷
干才	庸才
河清海晏	炮火连天
镇定自若	仓皇失措||毛骨悚然||手足无措||心惊肉跳||狼狈不堪||人心惶惶||失魂落魄
精装	平装||简装
九牛一毛	举不胜举
一泻千里	迂回曲折
大意	小心
他山之石	重蹈覆辙||就地取材
反面人物	正面人物
欢聚	失散||分离
及时	失时||耽误
身无长技	自成一家
买	卖
受害	受益
善罢干休	寻事生非||无理取闹
春寒料峭	春意盎然||春风和煦
上峰	下属
据理力争	理屈词穷||无理取闹
明枪暗箭	开诚布公
拾人牙慧	独辟蹊径||标新立异
鲜艳	素净||暗淡
无处容身	立足之地
挖空心思	无所用心
点铁成金	点金成铁
终结	开始
除恶务尽	养虎遗患||放虎归山
狐群狗党	良师益友||群英荟萃
打破沙锅问到底	一知半解
精神抖擞	筋疲力尽||萎靡不振||意志消沉||委靡不振
溃不成军	牢不可破||横扫千军
得过且过	急起直追||时不我待||再接再厉
泾渭分明	不问青红皂白||良莠不齐||认贼作父||薰莸同器||泾渭不分
六亲不认	普渡众生||与人为善||深情厚谊
惹事生非	安分守己
旗鼓相当	天差地别||寡不敌众||相形失色
洁净	肮脏
适得其反	如愿以偿
纯	杂
水落石出	匿影藏形
气吞山河	气息奄奄
供过于求	供不应求
忧心如焚	心花怒放
意气相投	一丘之貉||臭味相投
横扫千军	溃不成军||丢盔卸甲
无神论	有神论
丝丝入扣	东拉西扯||乱成一团||一团乱麻
采购	销售||经销
戒备森严	一触即溃
金光大道	荆棘载途
停航	起航
破绽百出	天衣无缝||无懈可击
叟	童
直言不讳	话中有话||旁敲侧击||曲意逢迎||吞吞吐吐||隐约其辞||钳口结舌||隐晦曲折
鹿死谁手	和平共处
无可非议	评头品足||张冠李戴
近因	远因
沦丧	收复
上口	拗口
急功近利	高瞻远瞩
飞沙走石	春光明媚||风和日丽
债主	债户
思绪万千	茫无头绪
驰名中外	臭名昭著
前台	后台||幕后
置之不理	另眼相看||刮目相看||却之不恭
不耻下问	神气活现||自高自大||师心自用
进口	出口
不可胜数	屈指可数||寥寥无几
瑕不掩瑜	瑜不掩瑕||瑜不掩霞
语无伦次	出口成章||顺理成章||头头是道||妙语如珠
知恩必报	恩将仇报
赤膊上阵	披坚执锐||披挂上阵
失而复得	不翼而飞
坤	乾
浑然一体	东鳞西爪||七拼八凑||七零八落||支离破碎
流离颠沛	安居乐业
隐蔽	公开||暴露
鸡犬不惊	鸡犬不留||鸡犬不宁
体力劳动	脑力劳动
弄巧成拙	弄假成真
死皮赖脸	悬崖勒马
自由王国	必然王国
无微不至	漠不关心
有意	无意
监禁	释放
拒谏饰非	闻过则喜||广开言路
顺天应人	强奸民意
恩将仇报	感恩戴德||感激涕零||以德报恩||感恩图报||知恩必报
富	穷
杳如黄鹤	捷报频传
唯心主义	唯物主义
概括	具体
立锥之地	广土众民||广阔天地
变态	常态
忠诚老实	盗名欺世
偃旗息鼓	大张旗鼓||卷土重来||迎风招展||大动干戈||重整旗鼓
肉中刺	掌上珠
扣题	离题
背离	遵循
离开	返回||接触||回来||回归
阴	阳||晴
解衣推食	以毒攻毒
本末相顺	本末倒置
文过饰非	闻过则喜||欲盖弥彰
仰不愧天	伤天害理
三番五次	绝无仅有
情景交融	格格不入
挺身而出	强人所难||畏缩不前||袖手旁观
苍天	大地
阻截	放行
忍气吞声	忍无可忍||宁为玉碎，不为瓦全
名实相符	叶公好龙
文不对题	探骊得珠
大腹便便	骨瘦如柴||面黄肌瘦
燕语莺声	龙吟虎啸
游牧	定居
清爽	恶浊
衰败	兴旺||鼎盛
莠	良
后福无量	后患无穷
披麻戴孝	张灯结彩
蛇蝎心肠	赤子之心
公然	暗地
城市	乡村||郊区
物伤其类	幸灾乐祸
遵从	违背||违反
慢	快
光阴似箭	度日如年
区别	混同
一夫之用	以一当十
大获全胜	大败亏输||片甲不回||一败涂地
败北	胜利||凯旋
巧	拙
安然无恙	不堪设想||千钧一发||山高水低||四面楚歌||朝不保夕||三长两短
为期不远	遥遥无期
点头之交	管鲍之交
欣喜若狂	怒气冲天||五内如焚||创巨痛深||痛不欲生||心如刀割
视同陌路	手足之情||亲密无间
委曲求全	含冤负屈||针锋相对||不卑不亢||喊冤叫屈
智尽能索	游刃有余
激浊扬清	讳疾忌医
山青水秀	穷山恶水
悲痛欲绝	抚掌大笑
全集	选集
人定胜天	靠天吃饭
妄下雌黄	言必有据||言之成理
潜逃	落网
轻描淡写	大书特书||淋漓尽致||小题大做||浓墨重彩
退场	上场
下任	上任
根深蒂固	头重脚轻||摇摇欲坠
明面上	暗地里
捎带	专门
上司	部属
中央	边缘
可恶	可喜||可爱
诨名	本名
众星捧月	各奔前程||离心离德
宁缺毋滥	滥竽充数||备位充数
赏心悦目	不堪入目||触目惊心
身心交病	身强力壮
妙趣横生	味同嚼蜡
维修	损坏
倒行逆施	不破不立||三从四德
瓦全	玉碎
未老先衰	返老还童||老当益壮
至交	死敌
缩小	扩大||夸大
车水马龙	门可罗雀||门庭冷落
闻风而起	纹丝不动
一成不变	白云苍狗||变幻莫测||朝令夕改||翻天覆地||风云突变||另起炉灶||日新月异||水涨船高||随机应变||五彩缤纷||物换星移||摇身一变||因地制宜||沧海桑田||见风使舵||千变万化||天翻地覆||喜怒无常||一改故辙
趾高气扬	谦虚谨慎
远因	近因
山高水低	安然无恙
谦谦君子	害群之马||专横跋扈||称王称霸
天上	地下
结尾	开头
一意孤行	博采众长||迷途知返||虚怀若谷||集思广益
哀伤	欢乐
不落窠臼	按图索骥
截然不同	平起平坐||一模一样
一气呵成	老牛破车||零敲碎打
供	求
好人	坏人
九死一生	安如泰山||安如磐石
等而下之	至高无上
衣锦荣归	离乡背井
美名	臭名
全体	部分
安之若素	如坐针毡
宁静	嘈杂||烦躁
一斑	全豹
空头	多头
当务之急	不急之务||一拖再拖||遥遥无期
庞大	精干||微小
团结友爱	龙争虎斗
烦躁	宁静
劫富济贫	为虎作伥||打家劫舍
腐朽	神奇
七嘴八舌	鸦雀无声||沉默寡言
基音	陪音
存放	领取
积重难返	痛改前非||拨乱反正
春色满园	冰天雪地||天寒地冻
断简残编	长篇大论||连篇累牍
散兵游勇	坚甲利兵
大败亏输	大获全胜
不可终日	处之泰然||安如泰山
短促	充裕
热情	冷淡||冷漠
开	关||盖
泄气	鼓劲
埋头苦干	不务正业||斗鸡走狗||纸上谈兵||游手好闲
徒弟	师傅
淘气	老实
相差无几	天壤之别||天壤悬隔
珍贵	普通
辽阔	狭窄||狭小||窄小
浑水摸鱼	夜不闭户||路不拾遗
残渣余孽	德才兼备||百里挑一
漠视	关注
虚度年华	死而后已
自食其力	城下之盟||坐享其成||不劳而获||寄人篱下
同舟共济	反目成仇||各行其事
唇亡齿寒	隔岸观火
毫无二致	迥然不同||千奇百怪
齐头并进	轻重缓急
守株待兔	通达权变
衣锦还乡	离乡背井||衣锦夜行
至关紧要	无关宏旨
对症下药	对牛弹琴||无的放矢
外语	母语
视如草芥	敝帚自珍||奉为圭臬||刮目相看
降级	升级||晋级
大失人望	大喜过望
糜费	节俭
巨	小
作法自毙	嫁祸于人
安邦定国	祸国殃民
舍生取义	见利忘义||贪生怕死||苟且偷生
妣	考
鬼迷心窍	大彻大悟
涓涓	滔滔
引言	后记
隐姓埋名	抛头露面||出头露面||引人注目
燃烧	熄灭||熄灭
身临其境	隔岸观火
卑下	崇高
抄近儿	绕远儿
方便之门	走头无路||山穷水尽
主词	宾词
洪亮	沙哑||低沉||微弱
相持不下	迎刃而解||急转直下
耐心	急躁
自在阶级	自为阶级
外号	本名
超然	随俗
利落	罗嗦
一分为二	相提并论
坚定不移	举棋不定||喜新厌旧||随波逐流||虚无缥缈
媾和	售、||宣战
寒冷	暖和||温暖||炎热
独立	依赖||附属
远	近
仁者见仁，智者见智	异口同声
囚禁	释放
转弯抹角	开门见山
精兵简政	叠床架屋||屋上架屋
破旧立新	因循守旧||萧规曹随
流露	掩饰
包罗万象	东鳞西爪||空空如也||一无所有
散文	韵文
野蛮	文明
趁热打铁	坐失良机
差	对
饱食暖衣	无衣无食||饥寒交迫
故	新
今	昔
稀溜溜	干乎乎
公正	偏私
俏丽	丑陋
倾诉	倾听
漠不相关	责有攸归
首屈一指	名落孙山
顺口	绕口||拗口
大块文章	言简意赅||要言不繁
独断专行	从善如流||群策群力||集思广益
横眉竖眼	和颜悦色
千奇百怪	毫无二致||千篇一律
韵母	声母
沙里淘金	泥沙俱下
包藏祸心	胸怀坦荡
大有可疑	毫无疑义
任人唯亲	人尽其才||知人善任||举贤任能||任人唯贤
无坚不摧	铜墙铁壁||不堪一击
面面相觑	从容不迫
盛气凌人	礼贤下士||谦虚谨慎||必恭必敬||平易近人
有人撑腰	无依无靠
裹足不前	高歌猛进||义无返顾||乘风破浪
消耗	积累
遵循	违反||背离
睹物思人	无动于衷
堕落	进步||上进
不求甚解	切磋琢磨||寻根究底
不经一事，不长一智	痴学不悟||顽固不化
领海	公海
一波三折	一帆风顺
信誓旦旦	言而无信
出其不意	不出所料
将信将疑	千真万确||信以为真||深信不疑
乔装打扮	本来面目||原形毕露
为非作歹	安分守己||嘉言懿行||循规蹈矩||谨言慎行
昼	夜
递加	递减
分散	联合||凑拢||结集||聚集||聚拢
戎马倥偬	安居乐业||安土重迁
一事无成	汗马功劳
接二连三	后继有人
反戈一击	同恶相济||朋比为奸
尽人皆知	默默无闻
眉清目秀	面目可憎||披头散发||獐头鼠目||蓬头垢面
踟蹰	果断
高超	拙劣
重起炉灶	冰消瓦解
空谷传声	杳无音信
硕大无朋	具体而微||微乎其微||鸡毛蒜皮||微不足道
肺腑之言	欺人之谈
旧俗	新风
说一不二	言而无信||出尔反尔
刚直不阿	八面玲珑
饱经风霜	少不更事||养尊处优||新硎初试
狂妄	谦虚
气势汹汹	和蔼可亲||心平气和
求乞	施舍
所向无敌	屡战屡败||望风披靡
白云苍狗	一成不变
缺欠	长处
同心同德	离心离德||同床异梦
神机妙算	束手无策
尾花	题花
喧宾夺主	客随主便
莫衷一是	一针见血
成千累万	一丝一毫
罚不当罪	十恶不赦||罪有应得
干脆	犹豫
仗势欺人	除暴安良||锄强扶弱
垂涎欲滴	淡泊寡味
轻举妄动	步步为营||谨言慎行||四平八稳||三思而行||稳扎稳打
方枘圆凿	水乳交融||一拍即合
青红皂白	是非分明
同床异梦	抵足而眠||情投意合||同病相怜||同心同德||同甘共苦
不分胜负	决一雌雄||决一死战
一言不发	高谈阔论||说长道短
和平	战争
见机行事	鲁莽行事||刻舟求剑
畏敌如虎	勇冠三军
零落	茂盛
请示	指示
赊购	赊销
敷衍了事	尽力而为||兢兢业业||全力以赴||三令五申
里	面||表||外
死不悔改	悔之无及
平常	异常
急于求成	从长计议||按部就班
大惊小怪	不足为奇||司空见惯
精打细算	粗心大意
守法	违法
旗开得胜	丢盔卸甲||四面楚歌||一溃千里||一触即溃
耿耿于怀	无介于怀||置之度外||置若罔闻
神魂颠倒	若无其事||神色不动
心心相印	格格不入||貌合神离||貌合心离
纵酒	戒酒
老成持重	初出茅庐||天真烂漫
真老虎	纸老虎
并驾齐驱	瞠乎其后||迥然不同||背道而驰
互不相干	遥遥相对
前人	后人
巧妙	蠢笨
急起直追	停滞不前||得过且过
叫苦不迭	眉开眼笑
免	任
入	出||舍
枉	正
峨冠博带	衣衫褴褛
慌忙	从容||镇定
畅达	晦涩
原本	简本
集约	粗放
无所事事	焚膏继晷||起早贪黑||日不暇给||时不我待||有所作为||废寝忘食||日理万机||席不暇暖
解约	缔约
择善而从	无所适从
担负	推卸
逆耳	顺耳||入耳
五颜六色	色彩单一
少	老
间断	持续
昏头昏脑	神志清醒||心明眼亮
正面	侧面
清冷	闷热
声名狼藉	流芳百世
吃苦	享福||享乐
移风易俗	因循守旧
张灯结彩	披麻戴孝
派遣	召回
承担	推脱
扶危济困	趁火打劫||落井下石
阳奉阴违	表里如一||心口如一
流离失所	安居乐业||安家立业
如数家珍	一无所知
后今薄古	颂古非今
兽	人
傩神	瘟神
光彩	丢人||羞耻||耻辱
敲骨吸髓	乐善好施
含沙射影	光明正大||直截了当
凄风苦雨	和风细雨
排斥	吸引
别树一帜	千篇一律
天不作美	三生有幸
执迷不悟	发人深省||翻然悔悟||回头是岸||清夜扪心||悬崖勒马||翻然改进||改邪归正||迷途知返||脱胎换骨
严惩不贷	姑息养奸
雕虫小技	雄才大略
历史唯物主义	历史唯心主义
翻然改进	执迷不悟
坚信	怀疑
随波逐流	坚定不移||中流砥柱||超然物外||推波助澜
旧交	新交
默默无闻	不甘寂寞||赫赫有名||尽人皆知||举世瞩目||石破天惊||崭露头角||举世闻名||遐迩闻名
容光焕发	筋疲力尽||面黄肌瘦
弹无虚发	百无一存||无的放矢
跋扈	恭顺
昏聩胡涂	耳聪目明
蛮横	和蔼
蒙蔽	揭露
乱无章	错落有致
财主	穷人
惩	奖
料事如神	防不胜防||鼠目寸光||目光如豆
蠢材	天才
露	藏||含||遮
赞成	反对
删	增
白	黑||皂
来而不往	礼尚往来
阴险	善良
百废待举	井井有条
上下其手	光明磊落
采取	放弃
千真万确	半信半疑||阴差阳错||将信将疑||阴错阳差
似是而非	不刊之论||天经地义
奉为楷模	视如敝屣
一拍即合	方枘圆凿||话不投机
愤愤不平	随遇而安||心平气和
骏马	驽马
留有余地	不遗余力
树碑立传	口诛笔伐
生效	失效
异口同声	大相径庭||众说纷纭||仁者见仁，智者见智||七嘴八舌
至多	至少
为仁不富	为富不仁
幸灾乐祸	同病相怜||物伤其类||兔死狐悲
空闲	繁忙||忙碌||紧张
过午	头午
先进	后进||落后
兼听则明	一面之词
绕远儿	抄近儿
无法无天	安分守己||循规蹈矩
煮鹤焚琴	怜香惜玉
不矜不伐	妄自尊大||自高自大
天崩地裂	万籁俱寂
限制	放手
掉以轻心	煞费苦心||小心翼翼
无缘	有缘
后发制人	先发制人||先睹为快
一针一线	斗牛车薪
唇齿相依	不关痛痒||势不两立||风马牛不相及
寿比南山	寿终正寝
大天白日	半夜三更
陆运	水运
毛	净
兴	除||衰
将校	军卒
省力	费力
成家立业	倾家荡产
志在四方	安土重迁||胸无大志
甜言蜜语	恶语中伤||忠言逆耳||推心置腹
博古通今	不学无术||漆黑一团
煞有介事	落落大方
稍息	立正
一心一意	见异思迁||心猿意马||筑室道谋
獐头鼠目	眉清目秀||英姿焕发||秀外慧中||英姿飒爽
明辨是非	混淆是非
雪白	漆黑||黢黑||乌黑
心胸狭窄	豁达大度
根深叶茂	枯木朽株||墙上芦苇
有板有眼	乱七八糟||杂乱无章
劣势	优势
引而不发	盘马弯弓
相形失色	旗鼓相当
不得要领	提纲挈领
放荡不羁	规行矩步||循规蹈矩
一视同仁	量才录用||因材施教||厚此薄彼
削发	蓄发
简易	繁难
金枝玉叶	赳赳武夫||蓬门荆布
火冒三丈	心平气和
乱	治||齐
铲除	扶植
解囊相助	一毛不拔
科班出身	半路出家
扬	抑||避
滾烫	冰凉
流浪	定居
嫌弃	亲近
红	绿
别扭	流畅||顺当
业精于勤	玩物丧志
失魂落魄	泰然自若||镇定自若
常客	稀客
削足适履	因地制宜
百无一失	漏洞百出
平年	闰年
意气用事	平心静气||三思而行
顿口拙腮	伶牙俐齿
早茶	夜宵
德薄才疏	德才兼备
全部	部分
稍纵即逝	天长地久||遥遥无期||旷日持久||天长日久
吐	吞
充裕	拮据||短促||紧迫
匹夫有责	敷衍塞责
如日方升	日暮途穷||江河日下
马不停蹄	岁月蹉跎||虚度光阴||停滞不前
盲人摸象	洞察一切||仰视观察
千篇一律	别有风味||千变万化||千奇百怪||物极必反||别具一格||别树一帜||天渊之别
左	右
动荡不安	天下太平||相安无事
力争上游	甘居人后||甘居下游
冰冷	火热
风平浪静	刀山火海||风吹浪打||惊涛骇浪||天摇地动||兴妖作怪||轩然大波||此伏彼起||风吹雨打||甚嚣尘上||汹涌澎湃||烟波浩渺
俯首听命	桀骜不驯||不卑不亢
头头是道	语无伦次
外貌	内心
明哲保身	惹火烧身||同流合污
行若无事	手忙脚乱
争先恐后	姗姗来迟
少见多怪	多见少怪||习以为常||见多识广
生不逢辰	吉人天相||应运而生
心中有愧	问心无愧||心安理得
弛缓	紧张
假手于人	公而忘私
前方	后方
始终如一	朝秦暮楚||翻云覆雨||循环往复
不仁不义	不念旧恶
置身事外	责无旁贷||置身其中
茫然不解	心领神会
人心向背	众望所归
天昏地暗	风和日丽||天朗气清
奴颜婢膝	大义凛然||坚贞不屈||威武不屈||神气活现
千言万语	只言片语
如坐云雾	恍然大悟
无影无踪	蛛丝马迹
丁是丁，卯是卯	藕断丝连
用非所学	学以致用
倒叙	顺叙
横七竖八	有条不紊
迂腐	开通
厌	喜
扎手	顺手
持之以恒	半途而废||一暴十寒||有始无终||浅尝辄止
塞翁失马	因福得祸
阮囊羞涩	腰缠万贯||堆金积玉
小试锋芒	大显身手
识途老马	初出茅庐
高峰	深谷
为民除害	草菅人命||助纣为虐
鸡毛蒜皮	硕大无朋||荦荦大端
通力合作	不近情理||名行其事
盟国	敌国
强烈	柔和||微弱
大义凛然	卑躬屈膝||奴颜婢膝
大而无当	娇小玲珑
乐天知命	战天斗地
怠惰	勤劳
暑	寒
花容月貌	其貌不扬
得胜	失败
兔死狗烹	感恩戴德
知难而退	逆水行舟||无所作为||锲而不舍||知难而进
断齑画粥	挥霍无度||挥金如土
青眼	白眼
通达权变	守株待兔||胶柱鼓瑟
酷爱	持而
名山大川	穷山恶水
老牛破车	快马加鞭||一气呵成
深信不疑	将信将疑||疑心生鬼
并行不悖	势不两立
四分五裂	精诚团结||一统天下||百川归海||万众一心
正常	异常
口诛笔伐	歌功颂德||树碑立传
振作	委靡
偷天换日	正大光明
穷山恶水	湖光山色||名山大川||山明水秀||山清水秀||山青水秀||鱼米之乡
结伴	单独||独自
宣战	媾和
细则	总纲
衣衫褴褛	风流倜傥||峨冠博带
力不胜任	得心应手
货次价高	货真价实
心腹之患	癣疥之疾
秦晋之好	反目成仇
心安理得	方寸已乱||七上八下||如坐针毡||忐忑不安||问心有愧||心中有愧||寝食不安||食不甘味||心烦意乱||惴惴不安
残缺不全	完好无损||完好无缺
大刀阔斧	束手无策||细针密缕||谨小慎微
老弱残兵	精兵猛将||兵强马壮
外交	内政||内务
记性	忘性
凯旋而归	全军覆没||落花流水
内行	外行
大题小作	借题发挥||变本加厉||小题大作
频频入礼	狂妄自大
瘠	腴
笼络人心	众叛亲离
参与	旁观
费	省
形影不离	天各一方||水火不容
中靶	脱靶
鸟瞰	仰望
犹豫不决	兵贵神速||死心塌地||一不做，二不休||斩钉截铁||当机立断
呕心沥血	粗制滥造
穷兵黩武	和平共处||解甲归田
鞭长莫及	不在话下
暴君	圣主
出奇制胜	按兵不动
刚强	软弱
结党营私	铁面无私
心急火燎	从容不迫
枵腹从公	穷奢极侈
史无前例	接连不断
双	单
卑贱	高贵
扬长避短	因陋就简||以短击长
流芳百世	谬种流传||声名狼藉||声色犬马||声色狗马||遗臭万年
片言之语	鸿篇巨制
爱憎分明	暧昧不明
当断不断	当机立断
轻佻	沉稳||庄重
洒	捡
罪上加罪	立功赎罪
宠辱不惊	宠辱若惊||患得患失
敬辞	谦辞
灵便	笨拙
欢	悲
字正腔圆	南腔北调
化合	分解
进退自如	进退维谷||进退两难
清闲	繁忙
拙嘴笨舌	能说会道
输	赢
无所不为	循规蹈矩||安分守己
鱼贯而入	破门而入
怒容	喜色
蒸发	凝结
顷刻之间	穷年累月
朱	墨
才气过人	才疏学浅
仔细	马虎||粗心
鄙陋	渊博
不辞劳苦	拈轻怕重
事与愿违	得心应手||如愿以偿||称心如意
一笔抹煞	生吞活剥
交头接耳	大声喧哗
东风化雨	暴风骤雨
国货	洋货
锦囊妙计	一筹莫展
鸦雀无闻	沸沸扬扬
懒散	紧张
额手称庆	垂头丧气
一毛不拔	挥金如土||慷慨解囊||一掷千金||解囊相助||倾囊相助||仗义疏财
施加	承受
触目惊心	司空见惯||赏心悦目||习以为常
成全	刁难
荒无人烟	稠人广座||人烟稠密
多头	空头
釜底游鱼	如鱼得水
朱门大户	蓬门荜户
口血未干	歃血为盟
颓废	振奋
五内如焚	心花怒放||欣喜若狂
自行灭亡	困兽犹斗
老骥伏枥	老气横秋
抛售	抢购
舍己为人	杀人越货||挑肥拣瘦||假公济私||损人利己
行有余力	心有余而力不足
怜新弃旧	惜玉怜香
浓墨重彩	轻描淡写
弱肉强食	和平共处
以古非今	古为今用
以己度人	推己及人
平心静气	大发雷霆||气急败坏||丧心病狂||意气用事
缓兵之计	兵贵神速||速战速决
沦落风尘	安家立业
疏浚	淤塞
启运	停运
整齐划一	参差不齐
文言	白话
自花传粉	异花传粉
乐不可支	肝肠寸断||叫苦连天||痛不欲生||乐极生悲
援助	求援
耸人听闻	本来面目||不偏不倚
万念俱灰	豪情壮志||雄心壮志||雄心勃勃||意气风发
稳如泰山	风雨飘摇||岌岌可危||危如累卵||一发千钧||担惊受怕||慌手慌脚||惊慌失措
循规蹈矩	痴人说梦||放荡不羁||胡作非为||肆无忌惮||偷香窃玉||为非作歹||无法无天||不成体统||放浪形骸||任其自然||随心所欲||无所不为
一鳞半爪	完美无缺||十全十美||一览无余
藏垢纳污	涤瑕荡垢
置身其中	置身事外
心广体胖	骨瘦如柴
度日如年	白驹过隙||寒来暑往||似水流年||光阴似箭||一刻千金
训斥	夸奖
憎称	爱称
蒙昧无知	学富五车
感恩戴德	不识抬举||痛心疾首||忘恩负义||恩将仇报||兔死狗烹||卸磨杀驴
开心	难受
从天而降	意料之中
步调一致	各行其是
开场	收场
呼之欲出	平淡无奇
加官进爵	时乖命蹇
曲突徙薪	临渴掘井
赏罚不明	赏罚分明
藏匿	暴露||显露||公开
受益	受害
只红不专	又红又专
记忆犹新	时过境迁
军官	士兵||战士
男盗女娼	男耕女织
名落孙山	金榜题名||首屈一指||名列前茅
解甲归田	穷兵黩武
前怕狼，后怕虎	胆大妄为
胸有成竹	茫无头绪||心中无数
口蜜腹剑	苦口婆心||心直口快
微贱	高贵
不足挂齿	有口皆碑||举足轻重
心烦意乱	心安理得||从容不迫
不足为奇	难能可贵||数一数二||大惊小怪
一如既往	朝令夕改||判若两人||取而代之||世态炎凉||另起炉灶||时过境迁
惜老怜贫	嫌贫爱富||欺贫爱富
庸俗	高尚
忍无可忍	忍气吞声||忍辱负重
拾取	抛弃||丢弃
不学无术	博大精深||博闻强记||博学多才||手不释卷||博古通今||博闻强识||多才多艺||真才实学
厚实	单薄
住口	开口
短缺	充足||丰盛
有余	不足
滴水穿石	半途而废||浅尝辄止
暖衣饱食	饥寒交迫
成千上万	寥寥无几||寥寥可数
心惊肉跳	神色不惊||镇定自若
酣畅淋漓	扦格不通
反躬自问	血口喷人||嫁祸于人||怨天尤人
半夜三更	红日三竿||大天白日||青天白日
娇生惯养	千辛万苦||百炼成钢
日	月
骚动	安定
勇往直前	不进则退||淡然处之||故步自封||望风而逃||趑趄不前||按部就班||打退堂鼓||望而却步
墙上芦苇	根深叶茂
放松警惕	常备不懈
分离	结合
高大	矮小||瘦小
旧雨重逢	冤家路窄||失之交臂
大手大脚	省吃俭用||细水长流||缩手缩脚
蹲点	跑面
以邻为壑	引咎自责
美观	丑陋
奇货可居	宝货难售
信以为真	将信将疑||疑神疑鬼
自怨自艾	自鸣得意
软绵绵	硬梆梆
盖世无双	司空见惯||屡见不鲜
微不足道	变本加厉||庞然大物||硕大无朋||洋洋大观
入世不深	老谋深算
金石为开	无动于衷
促退	促进
网开一面	小肚鸡肠
规行矩步	别开生面||不衫不履||放浪形骸||为所欲为||放荡不羁||肆无忌惮
见义勇为	隔岸观火||趁火打劫||唯利是图
进攻	撤退||防御||还击||抗击
大器晚成	不堪造就||冥顽不灵||初露锋芒
好好先生	凶神恶煞
特出	普通
慢性	急性
炙手可热	平易近人
犯而不校	针锋相对
起	止||伏
恶意	好心||善意
造谣生事	歌功颂德
优待	虐待
粗放	集约
起程	到达||抵达
过眼烟云	刻骨铭心
拯救	迫害
曲高和寡	下里巴人
我行我素	言听计从
眼高手低	量力而行
通宵达旦	一朝一夕
宽宏大量	斤斤计较||讨价还价
师出无名	名正言顺||师出有名
出类拔萃	滥竽充数||碌碌无能
稳如磐石	东摇西摆
毛糙	细致
兵	民||将
攻	守
缩手缩脚	不拘小节||大手大脚||随心所欲||放开手脚
封妻荫子	祸灭九族
生长	消亡
祖籍	客籍
布被瓦器	锦衣玉食
居高临下	礼贤下士
鸦雀无声	沸反盈天||人声鼎沸||七嘴八舌
相安无事	动荡不安||兴风作浪||浴血奋战||不堪设想
老搭档	新伙伴
义正言辞	奇谈怪论
心有余而力不足	行有余力
郁郁葱葱	赤地千里||寸草不生
翻然悔悟	死不改悔||执迷不悟
必恭必敬	盛气凌人
头伏	三伏
谨小慎微	不拘小节||大刀阔斧||丢三落四||随心所欲||无所畏惧||敢想敢干||玩世不恭
丰衣足食	嗷嗷待哺||饥寒交迫||艰难竭蹶||缺吃少穿||一穷二白||家徒四壁
心照不宣	百思不解
满招损，谦受益	刚愎自用
群岛	孤岛
管见	高见
劳动致富	不义之财
零	整
上级	下级
月黑风高	良辰美景
坚韧不拔	摇摆不定
金兰之契	酒肉朋友
锐敏	迟钝
方兴未艾	穷途末路||日暮途穷||再衰三竭
倾吐	倾听
助人为乐	乘人之危||助桀为虐||嫁祸于人
由衷之言	言不由衷
讳莫如深	无庸讳言
一人传虚，万人传实	百炼成钢
责怪	赞许||表扬
有条有理	杂乱无章||乱七八糟
潮湿	干燥
熙来攘往	万籁俱寂
白眼	青眼
风烛残年	风华正茂||徐娘半老
转福为祸	转祸为福
细微	显著||明显
锣鼓喧天	哑然失声||万籁俱寂
专政	民主
缩短	延长
不动声色	惊恐万状||声色俱厉||虚张声势||若有所失
节衣缩食	挥霍无度||铺张浪费
尽力而为	聊以塞责||敷衍了事
事不宜迟	来日方长
此伏彼起	风平浪静
逃之夭夭	岿然不动||天罗地网
外方内圆	外圆内方
疑团莫释	了如指掌
焊接	切割||割切||熔断
声嘶力竭	默默无言
欣欣向荣	每况愈下||心劳日拙
千变万化	一成不变||千篇一律||依然如故
晴天霹雳	司空见惯
名不副实	名实相副
左顾右盼	目不斜视||全神贯注
偷鸡摸狗	光明正大
子孙后代	列祖列宗
洪福齐天	祸不单行||灭顶之灾||劫后余生
东道	宾客
红润	苍白
失败	胜利||成功||得胜||取胜
笨拙	灵巧||灵便||敏捷
奋发图强	及时行乐||自暴自弃
驯服	反抗
凋蔽	繁荣
问心有愧	扪心无愧||心安理得||问心无愧
形而上学	辩证法
奸淫掳掠	扶老携幼||尊老爱幼
瓜分	独占||独吞
一厢情愿	两相情愿
百年不遇	屡见不鲜||司空见惯
货真价实	滥竽充数||货次价高
坚苦卓绝	轻逸无论
徒劳无益	行之有效||劳苦功高
鬼鬼祟祟	光明正大||明目张胆||光明磊落||正大光明
预付	赊欠||赊帐
宽贷	严惩
赖帐	认帐
搔头弄姿	落落大方||神态自若
喜从天降	祸从口出||天灾人祸||大祸临头||祸从天降
一日三秋	一刻千金
除暴安良	趁火打劫||仗势欺人||助纣为虐||以强凌弱||助桀为虐
汹涌澎湃	风平浪静
怨天尤人	反躬自问
颠三倒四	顺理成章||井然有序||有条不紊
和解	争执||争斗
一年半载	千秋万代||万古千秋
率由旧章	除旧布新||推陈出新
葱茏	枯萎
申雪	含冤
显露	藏匿
目光炯炯	黯然失色
平装	精装
勤俭	奢侈
蚕食	鲸吞
化缘	布施
减产	超产||增产
避	扬
含	露
恨	爱
生机勃勃	老气横秋||死气沉沉
顺当	别扭
可乘之机	无隙可乘
太阳	太阴
略	详
是非曲直	混为一谈
原形毕露	乔装打扮||匿影藏形
等闲视之	小题大作
面如土色	奔走相告||面不改色
污染	净化
名不虚传	徒有虚名||招摇撞骗
形单影只	前呼后拥||门庭若市||三五成群
大动干戈	偃旗息鼓||鸣金收兵
漂浮	沉没||沉浸
朝令夕改	一成不变||一如既往
楚才晋用	楚弓楚得
休战	开战
博采众长	刚愎自用||自以为是||一意孤行
幕后	前台
刻舟求剑	见机行事||审时度势||通权达变
详尽	粗略||简括
养虎遗患	除恶务尽||斩草除根||斩尽杀绝
添枝加叶	恰如其分||实事求是
陈陈相固	兴利除弊
因	果
忠	奸
肥头大耳	尖嘴猴腮||骨瘦如柴
放虎归山	除恶务尽||欲擒故纵||斩尽杀绝
锲而不舍	三天打鱼，两天晒网||知难而退||半途而废||浅尝辄止||一暴十寒||半途而废
凉爽	闷热||炎热||温暖
麻痹	警惕
会面	分手
破门而入	破门而出||鱼贯而入
心慌意乱	心旷神怡
愚公移山	虎头蛇尾
翻云覆雨	始终如一
富丽堂皇	家贫如洗||因陋就简
来龙去脉	有头无尾
杀鸡取卵	高瞻远瞩
慑服	悦服
半信半疑	千真万确
寻花问柳	正人君子
易如反掌	来之不易||难于登天
当之有愧	当之无愧
地心	地表
旁征博引	理屈词穷
能说会道	笨口拙舌||拙嘴笨舌
首鼠两端	干脆利落
生涩	流畅
总纲	细则
高视阔步	鹅行鸭步
旧调重弹	改弦易张
多如牛毛	不可多得||绝无仅有
缄口不言	谈天说地
津津乐道	绝口不道||沉默寡言||兴味索然
腹背受敌	各个击破
隐约	清楚
欣然	怅然
人言啧啧	赞叹不已
本	梢||标||末
张口结舌	慷慨陈词||滔滔不绝
功败垂成	水到渠成||大功告成
连用	单用
满登登	空荡荡
俗	雅
白圭之玷	十全十美
拂晓	薄暮
唯利是图	大公无私||见义勇为||急公好义
建设	破坏
撤退	进攻
鉴往知来	鼠目寸光
午夜	正午
归罪	归功
乐善好施	打家劫舍||群魔乱舞||伤天害理||无恶不作||豺狼成性||敲骨吸髓||下井投石
三从四德	倒行逆施||大逆不道
目瞪口呆	从容不迫||谈笑自若||气定神闲
弃暗投明	死不改悔||弃明投暗
逆子	孝子
正颜厉色	和蔼可亲
归降	背叛
谈虎色变	谈笑自若||面不改色
不得人心	深得人心||口碑载道
衰退	旺盛
自告奋勇	畏首畏尾||畏葸不前
兵贵神速	缓兵之计||犹豫不决||优柔寡断
不白之冤	真相大白
转义	本义
兴致勃勃	大煞风景||兴味索然
禁锢	释放
继续	中断
逍遥法外	法网难逃||天网恢恢，疏而不漏||绳之以法
嫡	庶
腐臭	芬芳
苦	甜||甘
东拉西扯	丝丝入扣||有条不紊
残月	新月
怒目而视	眉开眼笑||和颜悦色
合法	非法
后患无穷	斩草除根||后福无量
天怒人怨	歌功颂德
无名鼠辈	德高望重||大名鼎鼎
不拘小节	缩手缩脚||谨小慎微
好吃懒做	吃苦耐劳||事必躬亲
低级	高级
复习	预习
克己奉公	公报私仇||利欲熏心
方丈	沙弥
结余	亏空
芸芸众生	超凡入圣||超尘拔俗
味同嚼蜡	妙趣横生||其味无穷||洋洋洒洒
矫枉过正	恰到好处
如履平地	仰之弥高||如履薄冰
收敛	放纵
香花	毒草
残年	盛年
歌舞升平	大敌当前
冰冻三尺，非一日之寒	浅尝辄止
下笔成章	江郎才尽
人多势众	势单力薄||单枪匹马
形	神
固定	流动||浮动||活动
低贱	高贵
喜之不尽	苦不堪言
同流合污	洁身自好||明哲保身||疾恶如仇
满腹疑团	毫无疑义
维妙维肖	画虎类犬
荒年	丰年
复刊	停刊
四面楚歌	安然无恙||旗开得胜
无机	有机
否认	承认
细嚼慢咽	狼吞虎咽
尽如人意	大失所望||左支右绌
海外	海内||国内
薄利	暴利
轻	重
心怀叵测	胸襟坦荡||正大光明||赤胆忠心||襟怀坦白
旁敲侧击	单刀直入||开门见山||直截了当||耳提面命||开宗明义||直言不讳
逆水行舟	一帆风顺||知难而退
独具只眼	一无所长
贬值	升值
彻夜苦读	秉烛夜游
遮	露
放浪形骸	循规蹈矩||规行矩步
暖	冷||凉||寒
伸	缩
一丝不苟	粗枝大叶||浮光掠影||偷工减料||草草了事||丢三落四||马马虎虎
若无其事	六神无主||杞人忧天||丧魂落魄||张皇失措||若有所失||神魂颠倒||做贼心虚
述而不作	别开生面
招摇撞骗	实事求是||名不虚传
非法	合法
对	错||差
伏	起
力挽狂澜	力不能支
上膘	掉膘
眼明手快	呆头呆脑
精力充沛	精疲力竭||筋疲力尽
原料	成品
聪明睿智	冥顽不灵
乱七八糟	有板有眼||有条有理||整整齐齐
乏味	有趣
形形色色	如出一辙
失势	得势
义无反顾	畏首畏尾||瞻前顾后
称王称霸	谦谦君子
歹	好
遥遥无期	当务之急||稍纵即逝||指日可待||为期不远
洼陷	突起
不慌不忙	如饥似渴||—手忙脚||手忙脚乱
不计其数	聊胜于无||屈指可数
贴切	牵强
速	缓
果决	迟疑
自力更生	寄人篱下||仰人鼻息||坐享其成
鸿运高照	在劫难逃
跃进	爬行
左支右绌	左右逢源||尽如人意
寒色	暖色
口碑载道	不得人心||人言可畏||啧有烦言||民怨鼎沸||怨声载道
俗气	雅致||素雅
同甘共苦	同床异梦
窄小	宽大
完璧归赵	支离破碎
恋恋不舍	扬长而去||乐不思蜀
穷极无聊	精神饱满
水乳交融	格格不入||水火不相容||方枘圆凿||若即若离
一语中的	不痛不痒
寻死觅活	欢天喜地
死不改悔	翻然悔悟||改过自新||弃暗投明||脱胎换骨||放下屠刀，立地成佛
温文尔雅	咄咄逼人||喜怒无常||移山倒海||令行禁止
下水	上水
沉着	惊慌||仓皇||浮躁||慌张
清音	浊音
片言只语	连篇累牍||长篇大论
飞短流长	仗义直言
威武不屈	奴颜媚骨||奴颜婢膝
千差万别	半斤八两||一念之差
黑色金属	有色金属
洗耳恭听	充耳不闻
给予	接受||索取
应付自如	束手待毙||身不由己
有加无已	每况愈下
密集	稀疏||稀疏||疏落||稀少
低劣	优良||高明
活动	固定
穷途末路	方兴未艾||柳暗花明||四通八达||锦绣前程
光明磊落	鬼鬼祟祟||上下其手||邪门歪道||居心叵测||偷梁换柱||蝇营狗苟
望族	寒门
停运	启运
心慈面善	灭绝人性
笨口拙舌	灵牙利齿||巧舌如簧||能说会道
出人意表	不出所料
得	失
自强自力	城下之盟
内海	公海
求胜	求和
祸从天降	喜从天降
领袖	群众
七情六欲	四大皆空
摩拳擦掌	按兵不动
直线	折线
叹为观止	海底捞针
积水成渊	杯水车薪
无往不利	进退两难||骑虎难下
洞若观火	不得而知||管中窥豹||莫明其妙||管窥蠡测||莫名其妙||千头万绪
穷奢极侈	艰苦朴素||枵腹从公
无能为力	得心应手||胜任愉快||余勇可贾||大显神通||力所能及
直接	间接||辗转
生财之道	投机倒把
后	前||先
脑满肠肥	骨瘦如柴||形销骨立||鸠形鹄面
贺词	悼词
引以为荣	羞与为伍
上场	退场||下场
山珍海错	粗茶淡饭
不念旧恶	不仁不义
兔死狐悲	幸灾乐祸
不惑之年	豆蔻年华
厌烦	喜欢
珠围翠绕	荆钗布裙
义不容辞	推三阻四
直截了当	含沙射影||拖泥带水||拐弯抹角||旁敲侧击
贵族	平民
美中不足	十全十美
新鲜	腐败||陈旧
任	免
喜出望外	不堪回首||痛哭流涕
下马	上马
浴血奋战	和平共处||相安无事
开门见山	烘云托月||闪烁其辞||隐晦曲折||旁敲侧击||吞吞吐吐||转弯抹角
赊帐	预付
就	离
饱食终日	焚膏继晷||夙兴夜寐
弱不胜衣	钢筋铁骨||年富力强
怀柔	镇压
张扬	隐瞒
凑拢	分散
深透	肤浅
急不可待	来日方长||慢条斯理
偶一为之	韦编三绝||勤学苦练
金玉满堂	家徒四壁
难受	开心
姑息养奸	严惩不贷||斩草除根
不关痛痒	切肤之痛||血肉相连||唇齿相依||息息相关
坎坷不平	康庄大道
审时度势	刻舟求剑
豺狼当道	舜日尧天
以一当十	卵与石斗||一夫之用
崭露头角	默默无闻
北	南
公布于众	难言之隐
僵硬	柔软
自成一家	身无长技
冒名顶替	名副其实
毫无瓜葛	遥遥相对
养军千日，用在一时	养痈贻患
消声匿迹	粉墨登场
舍己为公	损公肥私
流言蜚语	金玉良言
吊丧	贺喜
温柔敦厚	尖酸刻薄||出言不逊
推销	收购
鹤发童颜	老态龙钟
图穷匕见	显而易见
不可多得	比比皆是||多如牛毛
日前月腹	家给人足
前所未闻	史不绝书||司空见惯
暗示	明说
宁死不屈	苟且偷生||苟延残喘||屈膝投降||苟全性命||屈打成招
浅	深
百端待举	百废待兴
下1	上
改朝换代	铁打江山
乘人之危	济困扶危||助人为乐||雪中送炭
芳香	恶臭
出征	班师
冰天雪地	冰雪消融||春色满园||汗流浃背||大地回春
空前绝后	承前启后||比比皆是
一诺千金	背信弃义||轻诺寡信||空头支票
排外	媚外
明目张胆	暗渡陈仓||鬼鬼祟祟||偷偷摸摸||暗送秋波
无可奈何	诚心诚意
闻风丧胆	泰然自若
各奔前程	万众一心||众星捧月||相依为命
避实击虚	避重就轻
拘押	释放
不即不离	寸步不离
敷设	拆除
见利忘义	富贵不能淫||见贤思齐||见利思义||舍生取义
面向世界	闭关锁国
签发	签收
得到	失掉
依然如故	变幻莫测||改头换面||面目全非||千变万化||万象更新||面目一新||一了百了
功勋	罪恶
尽心竭力	敷衍塞责
蛛丝马迹	千丝万缕||无影无踪
视死如归	苟延残喘||贪生怕死
更换	照旧
反求诸己	苛求于人
情深似海	恨入骨髓
如胶似漆	反目成仇
急公好义	唯利是图
懒	勤
人	神||鬼||兽
敬重	轻慢
开化	愚昧||冻冰
百感交集	铁石心肠||无动于衷
狼烟四起	国泰民安||太平盛世||平安无事
收	发||播||放||缴||撒||送
瓮中之鳖	漏网之鱼
小户	大户
淡月	旺月
肝胆相照	勾心斗角||假人假义||明争暗斗||钩心斗角
灭绝人性	心慈面善
心怀鬼胎	正大光明
学富五车	蒙昧无知||不辨菽麦||目不识丁
招摇过市	匿影藏形
屈膝投降	宁死不屈
一窍不通	触类旁通||全知全能||无所不知||洞察一切||无所不通
名副其实	画饼充饥||冒名顶替||名存实亡||色厉内荏||叶公好龙||滥竽充数||有名无实||名不副实
心猿意马	乐此不疲||一心一意||目不窥园
安营	拔营
蠢如鹿豕	聪明伶俐
往	来
甘	苦
因时制宜	不合时宜
不破不立	老调重弹||倒行逆施
康健	虚弱
滔滔不绝	避而不谈||哑口无言||张口结舌
一无所长	独具只眼||拿手好戏||一技之长||三头六臂
败而不馁	楚囚对泣
火上浇油	釜底抽薪
团体	个人
荒歉	丰收
名列前茅	名落孙山
避实就虚	以卵击石
杯水车薪	积水成渊
过	功
宾至如归	漠不关心||冷若冰霜
蛟龙失水	蛟龙得水
不劳而获	徒劳无功||自食其力
亏	盈||余
瞬息之间	年深日久
不见薪新	明察暗访
革新	守旧||复古
洋货	国货
指天画地	欲言又止||吞吞吐吐
尊老爱幼	奸淫掳掠
凝华	升华
硬	软
脆弱	坚强
募化	施舍
保卫	侵犯
滑腻	粗糙
弄假成真	画蛇添足||弄巧成拙
攒	花
间或	时常
七步之才	呆头呆脑
丢三落四	一丝不苟||谨小慎微
喜形于色	闷闷不乐||如丧考妣||忧心忡忡||心如铁石
抓	放
视如敝屣	垂涎三尺||奉为圭臬||奉若神明||奉为楷模
一针见血	隔靴搔痒||不痛不痒||莫衷一是
俯首帖耳	桀骜不驯
举贤任能	任人唯亲
信赏必罚	既往不咎
中心	边缘||周围
风凉	闷热
素净	鲜艳
不由分说	强词夺理||无理取闹
谦和	傲慢
推诚相见	明争暗斗||钩心斗角
豺狼成性	乐善好施
大灾三年	风调雨顺
高亢	低沉||低微
暂停	久留
征聘	应聘
一无长物	腰缠万贯
割席分座	海内存知己，天涯若比
棋逢对手	略胜一筹||棋高一着
蜷缩	伸展||伸直
缴	收
真伪莫辨	昭然若揭||真相大白
一败涂地	大获全胜||百战不殆
调兵遣将	按兵不动||鸣金收兵||班师回朝
正中下怀	大失所望
神态自若	搔头弄姿
悠闲自得	疲于奔命
前赴后继	临阵脱逃||畏缩不前
铁证如山	空口无凭||无中生有
资方	劳方
三缄其口	口若悬河||信口开河||夸夸其谈
意气风发	万念俱灰
数一数二	平淡无奇||不足为奇
斗鸡走狗	日理万机||埋头苦干
望风披靡	所向无敌||所向披靡
仗义执言	违天悖理
仓皇	沉着
杀人不见血	与人为善
不可名状	一语破的
远在天边	近在眼前||近在眉睫||迫在眉睫
轻重倒置	提纲挈领
赞不绝口	令人作呕
别致	普通
寥寥可数	成千上万
独出心裁	如法炮制
另眼相看	置之不理
了如指掌	不得而知||一团漆黑||疑团莫释||似懂非懂
简装	精装
惜玉怜香	喜新厌旧||怜新弃旧
后卫	前卫||先锋
正旦	除夕
傲慢	谦逊||谦和
注重	轻视
旱季	雨季
先手	后手
退休	在职
难兄难弟	恩断义绝
一触即溃	壁垒森严||坚不可摧||举世无敌||旗开得胜||戒备森严||战无不胜
除夕	元旦||正旦
爱屋及乌	爱莫能助
与虎谋皮	行之有效
上面	下面
违法乱纪	奉公守法
春风和煦	春寒料峭
推斥力	吸引力
设身处地	随心所欲
笑里藏刀	心口不一
口是心非	赤胆忠心||馨香祷祝||心口如一
自杀	他杀
临阵磨刀	磨砺以须
亲近	疏远||嫌弃
如堕烟海	豁然开朗
焦头烂额	万事亨通
全军覆没	得胜回朝||凯旋而归
安不忘危	麻痹大意
乞	赐
心有余悸	神色不惊||泰然自若
乱点鸳鸯	天作之合||成人之美
粗枝大叶	精雕细刻||细针密缕||一丝不苟
年老体衰	宝刀不老
兼收并蓄	以蠡测海
举手投足	九牛二虎之力
一马平川	崇山峻岭||千山万壑||千岩万壑||龙盘虎踞||万壑千岩
饥不择食	挑肥拣瘦
浅近	深奥
不苟言笑	手舞足蹈||油腔滑调||谈笑风生
饮水思源	得鱼忘筌||过河拆桥||数典忘祖
锄强扶弱	仗势欺人
怙恶不悛	回头是岸
一丘之貉	良师益友||意气相投||黑白分明||是非分明
天长日久	稍纵即逝
和睦相处	相煎何急
箭不虚发	无的放矢||百无一存
历历在目	昏天黑地
不甘示弱	甘拜下风
唯命是从	大逆不道||桀骜不驯
超产	减产
光宗耀祖	奇耻大辱||丧权辱国
闪烁其辞	锋芒逼人||心直口快||开门见山
上限	下限
顺水推舟	横生枝节
望而生畏	楚楚可怜||无所畏惧
话不投机	言归于好||一拍即合
平淡无味	脍炙人口
言不由衷	由衷之言
不可捉摸	一目了然
欢歌笑语	长吁短叹
众目睽睽	掩人耳目||旁若无人
徐娘半老	人老珠黄||风烛残年
红口白牙	隐恶扬善
有的放矢	对牛弹琴
故地重游	新来乍到
以身殉职	玩忽职守
内外交困	万事亨通||左右逢源
死气沉沉	轰轰烈烈||生机勃勃||生气勃勃||朝气蓬勃
面目可憎	眉清目秀||小鸟依人||仪态万方||千娇百媚
损兵折将	锐不可当
春风满面	愁眉苦脸
无	有
杂牌军	正规军
外柔内刚	外强中干
大局	局部
襟怀坦白	居心叵测||心怀叵测
百不一存	百发百中
自暴自弃	奋发图强||妄自尊大||自强不息||闻鸡起舞
确凿不移	海外奇谈||捕风捉影
自惭形秽	厚颜无耻||自命不凡||孤芳自赏
心花怒放	黯然销魂||五内俱焚||忧心如焚||肝肠寸断||五内如焚
男耕女织	男盗女娼
胜任愉快	一无所能||无能为力
太平盛世	家破人亡||狼烟四起
互为表里	行同陌路
光滑	粗糙
金字招牌	臭名远扬
无与伦比	不相上下
危害	维护
节省	浪费||耗费||a节省节约a
门庭冷落	车水马龙||门庭若市
恩赐	乞求
欢庆	哀悼
安贫乐道	愤世嫉俗||为所欲为||胡作非为
重于泰山	秋毫之末||轻于鸿毛
零售	批发
爬梳剔抉	兼容并包
劈头盖脸	和风细雨
脱胎换骨	死不改悔||执迷不悟||顽固不化
气急败坏	平心静气||心平气和
罚	赏
分工	合作
常数	变数
钩心斗角	肝胆相照||推诚相见
不寒而栗	临危不惧||无所畏惧
四体不勤，五谷不分	不辞辛劳||孜孜不倦
食不甘味	心安理得||泰然处之
冷冷清清	热热闹闹
临渴掘井	曲突徙薪||有备无患||常备不懈
首席	末座
魑魅魍魉	志士仁人
目不斜视	左顾右盼||侧目而视
轻蔑	尊敬||尊重
勤勉	懒惰
如虎添翼	雪上加霜
有所作为	无所用心||无所事事
骄兵必败	哀兵必胜
以理服人	以力服人
漏网	落网
偏	正||全
风雨如晦	天朗气清||风和日丽
量	质
绣花枕头	真才实学
纵横交错	井井有条||有条不紊
生龙活虎	老气横秋||人困马乏
无家无业	安家立业
乳臭未干	后生可畏
声色狗马	流芳百世||名垂青史
危如累卵	安如泰山||安如磐石||稳如泰山
惹是非	守规矩
重整旗鼓	偃旗息鼓||背水一战
尖	团||钝
亡羊补牢	防患未然||知错不改||未雨绸缪
胜利	失败||败北||失败
飞扬跋扈	平易近人
难言之隐	公布于众||开诚布公
醒	睡||醉
正文	附录||注解
交臂失之	机不可失
针锋相对	犯而不校||逆来顺受||退避三舍||相忍为国||吠影吠声||气味相投||委曲求全
平步青云	穷困潦倒||一蹶不振
一得之见	真知灼见||博学多才
凶残	仁慈
任其自然	循规蹈矩
小人	君子
形式	内容
回天之力	回天乏术
镇压	安抚||怀柔
附属	独立
上帐	销帐
归心似箭	浪迹天涯
深层	表层
如鸟兽散	云合雾散||乌合之众
畅所欲言	闭口不言||吞吞吐吐
好为人师	学而不厌
喜怒哀乐	心平气和
假公济私	奉公守法||公事公办||舍己为人||公而忘私
后继无人	后继有人||传宗接代||人才辈出
可想而知	不可思议
任重道远	无所作为
惴惴不安	心安理得||悠然自得
返老还童	未老先衰
掩盖	揭露||表露||揭穿||揭开
比比皆是	空前绝后||不可多得||硕果仅存
举目无亲	亲密无间||形影相随
面不改色	面红耳赤||谈虎色变||面如土色
施行	废除
干瘪	饱满
头破血流	马到成功
海内	海外
佳音	噩耗
理想	现实
模糊不清	炯炯有神
废寝忘食	无所事事
宾客	主人||东道
按兵不动	蠢蠢欲动||劳师动众||摩拳擦掌||神出鬼没||出奇制胜||调兵遣将||雷厉风行||倾巢而出
推己及人	诿过于人||以己度人
门庭若市	门庭冷落||形单影只
冗长	简洁||简短||凝练
聪慧	愚蠢
鸡犬不留	鸡犬不惊||秋毫无犯
年末	年初
息息相关	不关痛痒||漠不关心
失陷	光复
掉膘	上膘
膨胀	收缩
泾渭不分	泾渭分明
明火执杖	暗渡陈仓
面	背||里
山珍海味	残杯冷炙||粗茶淡饭||家常便饭||残羹冷炙||粗衣粝食
愚笨	聪敏
水滴石穿	虎头蛇尾
地	天
平反昭雪	沉冤莫白||降志辱身
虚岁	足岁
供认不讳	矢口否认
阴错阳差	千真万确
还击	进攻
泥古不化	革故鼎新||推陈出新
侵略	抵抗
单程	往返
瞠目结舌	应对如流
温暖	寒冷||凉快||凉爽
本质	现象
操心	省心
深刻	肤浅
黑	白||赤
护	毁
仰人鼻息	自力更生||独当一面
心口如一	八面玲珑||口是心非||炫玉贾石||阳奉阴违
伟人	凡人
坚甲利兵	赤手空拳||乌合之众||散兵游勇
优厚	菲薄
瑜	瑕
胡思乱想	确信不疑
世代相传	旷古绝伦
推三阻四	当仁不让||责无旁贷||义不容辞
混乱	井然
首当其冲	畏缩不前
置之脑后	言犹在耳
生花妙笔	平淡无奇
天差地远	不相上下
火中取栗	坐享其成
主角	配角
应	呼
自用	公用
背道而驰	并驾齐驱||马首是瞻||殊途同归
查封	启用
日薄西山	来日方长||如日中天||蒸蒸日上||喷薄欲出||旭日东升
钢筋铁骨	弱不胜衣
原封不动	不翼而飞||改头换面||变化无穷
以毒攻毒	解衣推食
诚心诚意	无可奈何||冷言冷语
机不可失	失之交臂||交臂失之
一无可取	完美无缺
花	攒
阔绰	清苦||清贫
养尊处优	含辛茹苦||苦大仇深||饱经风霜||积劳成疾
画饼充饥	名副其实
魂牵梦萦	大梦初醒||恍然大悟
矮小	高大
出人头地	相形见绌
降落	升起||起飞
固步自封	一往无前
困兽犹斗	束手待毙||放下屠刀||自行灭亡
欺人之谈	金玉良言||肺腑之言
停业	开业||开张
杂乱无章	井井有条||鳞次栉比||有板有眼||有条有理||错落有致||井然有序
没落	兴旺
恶语中伤	甜言蜜语
不偏不倚	耸人听闻
呼	吸||应
再衰三竭	方兴未艾
初生牛犊	惊弓之鸟
童年	暮年
满不在乎	郑重其事
异常	正常||平常
荒谬绝伦	理所当然||天经地义
矫柔造作	天造地设
生水	开水
揭开	掩盖||覆盖
休戚相关	漠不关心
奇珍异宝	竹头木屑
卑躬屈膝	大义凛然||坚强不屈||龙行虎步||不屈不挠
不攻自破	颠扑不破
所向披靡	弃甲曳兵||望风披靡||弃甲丢盔||畏缩不前
清除	扩散
新教	旧教
拗口	顺口||上口
家徒四壁	丰衣足食||家财万贯||金玉满堂
晨曦	暮霭
短途	长途
以一警百	杀一儆百
发慌	塌实
紧迫	充裕
不遗余力	三心二意||留有余地
疑神疑鬼	信以为真
补益	贻害
粗衣粝食	山珍海味
不厌其详	语焉不详
清脆	沙哑||沉闷
独木难支	砥柱中流
三言两语	喋喋不休||讨价还价||连篇累牍
超凡入圣	无名小卒||百无一是||芸芸众生
留鸟	候鸟
因地制宜	削足适履||一成不变
奢华	俭朴
工人阶级	资产阶级
时兴	过时
崇敬	蔑视
恶劣	优良||良好||优越
怒形于色	喜不自胜
争长论短	甘拜下风
下场	上场
支取	储存
财运亨通	穷困潦倒||时乖运蹇
疑	信
溜之大吉	一往无前
创巨痛深	欣喜若狂
咎由自取	回头是岸
枝节	根本
更动	照旧
貌合心离	心心相印
耳聪目明	闭目塞听||昏聩胡涂||不省人事
文质彬彬	赳赳武夫||野调无腔||威风凛凛
水泼不进	见缝插针
取得	失去
中流砥柱	擎天柱石||随波逐流
疏通	堵塞||壅塞||淤塞
暴跳如雷	心平气和
寡廉鲜耻	廉洁奉公
春光明媚	天寒地冻||飞沙走石
百年之好	夫妻反目||破镜难圆
高涨	低落
赤子之心	蛇蝎心肠||狼心狗肺
虚无缥缈	坚定不移
茫无头绪	胸有成竹||思绪万千
惨绝人寰	仁至义尽
风调雨顺	狂风暴雨||大灾三年
滴水不漏	漏洞百出
旁支	嫡系
锋芒毕露	不露圭角||不露锋芒||退避三舍
富饶	贫穷
空头支票	一诺千金
功绩	过错
电光石火	旷日持久
壅塞	疏通
岌岌可危	稳如泰山
胸无大志	志在四方
颠倒黑白	实事求是||黑白分明
说三道四	相对无言||默不做声
和颜悦色	咄咄逼人||横眉立眼||疾言厉色||怒目而视||青面獠牙||正言厉色||发指眦裂||横眉竖眼
鲜明	隐晦||暗淡
各行其事	同舟共济
情不自禁	不露声色||无动于衷
讨伐	安抚
单枪匹马	人多势众||千军万马
评头品足	无可厚非||无可非议
气喘吁吁	心平气和
神奇	腐朽||普通||平庸
大喜过望	大失人望||不堪回首
发财	受穷
居心叵测	光明磊落||推心置腹||不打自招||襟怀坦白
离乡背井	安土重迁||衣锦荣归||衣锦还乡
铁案如山	屈打成招
不绝如缕	牢不可破||龙吟虎啸
敞开	关闭
新仇旧恨	大恩大德
整装	散装
简缩	扩展
娇小玲珑	大而无当
悔之无及	顽固不化||死不悔改
灵活	呆板||拘泥
徇私枉法	秉公执法
无穷	有限
破裂	弥合
不疾不徐	过犹不及
独吞	瓜分
锐	钝
万籁无声	震耳欲聋||人声鼎沸
卸磨杀驴	感恩戴德||一往情深
仇恨	友爱
委靡不振	精神抖擞||慷慨激昂
咄咄逼人	和风细雨||平易近人||和颜悦色||温文尔雅
管	惯
丧事	喜事
旷古绝伦	世代相传
放肆	检点||拘束||谨慎
不露圭角	锋芒毕露
精诚团结	分化瓦解||四分五裂||挑拨离间
开放	凋谢||封锁||封闭
雄心勃勃	万念俱灰
旦	夕
痛不欲生	乐不可支||欣喜若狂
如胶如漆	反目成仇||分道扬镳
千里迢迢	望衡对宇||朝发夕至
因循坐误	分秒必争
近在眉睫	远在天边
污浊	清洁
一本万利	事倍功半||徒劳无功
推	拉||提
味如嚼蜡	回味无穷
无隙可乘	可乘之机||有机可乘||乘虚而入||有隙可乘
法不阿贵	贪赃枉法
幡然悔悟	屡教不改
灯火辉煌	黑灯瞎火||昏天黑地
无耻之尤	廉洁奉公
胆小如鼠	不入虎穴，焉得虎子||浑身是胆||无所畏惧||胆大包天||矜才使气
俊俏	丑陋
割切	焊接
一语破的	不可名状||隔靴搔痒
凋落	茂盛
生气勃勃	暮气沉沉||死气沉沉||槁木死灰||气息奄奄
改良	守旧
一代奸雄	一代风流
因福得祸	塞翁失马
无庸讳言	讳莫如深
昭雪	含冤
爱财如命	挥金如土||仗义疏财
拒绝	接受
情同骨肉	势不两立
必不可少	多此一举
译文	原文
残山剩水	锦绣河山
和气	粗暴
正规军	游击队||杂牌军
出尔反尔	说一不二
利令智昏	见利思义
涕泗滂沱	眉开眼笑||笑容可掬
灰暗	明朗
悠然自得	拍案而起||若有所失||忐忑不安||惴惴不安
狂风暴雨	风调雨顺
情急智生	束手无策||一筹莫展
喜爱	讨厌||嫌恶||厌弃
法人	自然||自然人
穿凿附会	融会贯通
倒伏	挺立
幻想	现实
混同	区分||区别
奇	偶
群	干
取信	失信
坐以待毙	笨鸟先飞||绝处逢生||三十六策，走为上策||死里求生||狡兔三窟||柳暗花明||三十六计，走为上计
官吏	百姓
井浅河深	门当户对
扑朔迷离	不言而喻||一清二楚
直率	婉转
最小公倍数	最大公约数
通好	绝交
笑容可掬	愁眉苦脸||热泪盈眶||涕泗滂沱||咬牙切齿||泣不成声||声泪俱下
郎才女貌	无德无才
庐山真面目	改头换面
丹凤朝阳	怀才不遇
因循守旧	革故鼎新||破旧立新||除旧布新||匠心独运||推陈出新||移风易俗
增进	减退
悦耳	难听||刺耳
晚点	正点
浅尝辄止	冰冻三尺，非一日之寒||持之以恒||滴水穿石||坚持不懈||锲而不舍||冰清玉洁||切磋琢磨
畅销	滞销
贻害	造福||补益
杀生	放生
沉	浮
进退维谷	进退自如
动乱	安定||升平
暴政	仁政
定期	活期
金戈铁马	天下太平||轻歌曼舞
厚今薄古	厚古薄今
幼	成||长
嫌恶	喜爱
鸡犬不宁	鸡犬不惊||莺歌燕舞||夜阑人静
精雕细刻	粗枝大叶||偷工减料
一言不语	娓娓动听
运动	静止
暖和	凉快||寒冷||阴冷
狠	慈
春意盎然	春寒料峭||春意阑珊
紧凑	松散
兴起	衰亡
举足轻重	不足挂齿||轻于鸿毛||微乎其微||无关宏旨||细枝末节||不屑一顾||无关大局||无足轻重
背水一战	重整旗鼓
柳暗花明	山穷水尽||坐以待毙||穷途末路||走投无路
末座	首席
千载一时	俯拾即是
听而不闻	有闻必录
大海捞针	手到擒来||信手拈来||唾手可得
登峰造极	屡见不鲜
专门	顺便||捎带
机关算尽	束手无策||无计可施
万事大吉	节外生枝||艰难曲折
言无二价	欺行霸市
一筹莫展	大显神通||情急智生||游刃有余||锦囊妙计||稳操胜券
欺行霸市	言无二价
借题发挥	单刀直入||大题小作
浪子回头	屡教不改
一贫如洗	家财万贯||无所不包
横冲直撞	首尾相应
势单力薄	大气磅礴||人多势众
文明	野蛮
班师	出师||出征
琅琅上口	诘屈聱牙||佶屈聱牙
人人自危	高枕无忧
歧路亡羊	改邪归正
叫苦连天	眉开眼笑||乐不可支
深恶痛疾	情深意重
兵强马壮	赤手空拳||老弱残兵
赳赳武夫	文弱书生||金枝玉叶||文质彬彬
成人之恶	成人之美
轻歌曼舞	金戈铁马
残败	茂盛||繁盛
四海为家	归去来兮
百思不解	心照不宣
有气无力	精神焕发||生气勃勃
语焉不详	不厌其详||彰明较著
酷热	严寒
屈指可数	不可胜数||恒河沙数||指不胜屈||不一而足
娶	嫁
后天	先天
人民	敌人
一去不复返	反复无常
郁悒	愉快
嬉皮笑脸	一本正经
费力	省力
低三下四	高人一等||龙行虎步
清醒	昏迷||发昏||恍惚||糊涂
大方	小气||忸怩||羞怯
光天化日	荆天棘地||暗无天日
按期	超期
歌功颂德	天怒人怨||造谣生事||诅咒、诋||口诛笔伐||怨声载道
倒打一耙	是非分明||以德报怨
地广人稀	弹丸之地||摩肩接踵||地狭人稠
出何典记	言之有据
精益求精	粗制滥造||望文生义
好高骛远	脚踏实地||实事求是||千里之行，始于足下
丰富	缺乏||匮乏||贫乏||单调
触景生情	无动于衷
收藏	散失
下碇	起锚
衣冠楚楚	不衫不履||鹑衣百结
不言而喻	模棱两可||强词夺理||扑朔迷离
战士	军官
升平	动乱
眼见为实	三人成虎
前卫	后卫
江心补漏	防微杜渐||有备无患
相依为命	各奔前程
求全责备	求同存异||人无完人
走马上任	削职为民
有方	无方
惩处	嘉奖
寿辰	忌日
得鱼忘筌	饮水思源
脱节	联系
学生	老师||先生
百川归海	四分五裂||众叛亲离
离队	归队
闷闷不乐	手舞足蹈||喜形于色||兴高采烈||喜不自胜
寿	夭
误	正
出生入死	贪生怕死
时乖运蹇	财运亨通
桑榆暮景	风华正茂||如日中天
别	逢
震耳欲聋	万籁无声||万籁俱寂||鸦雀无声
和平共处	龙争虎斗||枪林弹雨||弱肉强食||大张挞伐||鹿死谁手||穷兵黩武||浴血奋战
琳琅满目	疮痍满目
洁身自好	同流合污
丰美	枯萎
心明眼亮	昏头昏脑||笨头笨脑
后生可畏	乳臭未干||少不更事
方便	麻烦
廉政自守	诛求无已
忘恩负义	感恩图报||结草衔环||叶落归根||以直报怨||感恩戴德
推翻	建立
勤学苦练	偶一为之
跌落	上升
繁茂	稀疏
情随事迁	始终不渝
坐享其成	火中取栗||自力更生||自食其力
毫厘不爽	张冠李戴||天差地别
特殊	一般||普通
夏	冬
假仁假义	开诚相见||坦诚相待
秀丽	丑陋
不辨菽麦	学富五车||博学多才
狼狈不堪	镇定自若||从容不迫
整个	部分
迫不得已	甘心情愿||何乐而不为
丰沛	稀少
阳春白雪	下里巴人
塌	撑
入不敷出	量入为出||绰绰有余
舍	入
时来运转	生不逢时
暴戾恣睢	慈眉善目
源源不绝	断断续续
交出	接收
犬牙交错	整整齐齐
活泼	呆板||严肃||严肃
一团和气	蛮横无理||凶相毕露||凶神恶煞
螳臂当车	泰山压卵||量力而行
回师	出师||兴师
压服	说服
亲眼目睹	视若无睹
熔断	焊接
痛恨不已	喜闻乐见
尖锐	迟钝
露脸	丢脸
做东	做客
捡	洒||扔
无可厚非	评头品足
不翼而飞	失而复得||原封不动
自家	人家
朝发夕至	千里迢迢
如丧考妣	如获至宝||喜形于色||弹冠相庆||喜笑颜开
清贫	阔绰
理屈词穷	理直气壮||名正言顺||振振有辞||据理力争||淋漓尽致||旁征博引
千山万壑	一马平川
独占	瓜分
分庭抗礼	和衷共济||同心协力
孤立	联系||联合||团结
曲意逢迎	直言不讳
老牛舐犊	深恶痛绝
千军万马	单枪匹马||一成一旅
迎头赶上	甘拜下风
乡	城
赏罚分明	官官相护||赏罚不当||赏罚不明
猝不及防	防患未然
心狠手辣	心慈面软||菩萨心肠||心慈手软
以内	以外
分居	同居
轻快	沉重
开市	收市
道听途说	耳闻不如目见
惯	管
狐假虎威	独步天下
顾虑	放心
妙不可言	兴味索然
损坏	修理||维修
大敌当前	高枕无忧||歌舞升平
媚外	排外
失利	取胜
回味无穷	索然无味||味如嚼蜡
另起炉灶	双管齐下||一如既往||一成不变
画虎类犬	惟妙惟肖||跃然纸上||维妙维肖
痴心妄想	切中事理
加紧	放松
压	抬
这	那
破门而出	蜂拥而入||破门而入
自轻自贱	自强不息||妄自尊大
卒	生
有条不紊	颠三倒四||东拉西扯||胡言乱语||七手八脚||手忙脚乱||纵横交错||横七竖八||千头万绪
坚硬	松软||柔软
情有可原	不可思议
忧心忡忡	无忧无虑||喜形于色||喜笑颜开||笑逐颜开
小鸟依人	深恶痛绝||面目可憎
形影相随	举目无亲
百无一存	箭不虚发||弹无虚发
长机	僚机
暴风骤雨	东风化雨||和风细雨
长篇大论	断简残编||片言只语||简明扼要
井然有序	杯盘狼藉||颠三倒四||污七八糟||杂乱无章||错综复杂||乌七八糟||一塌糊涂
噤若寒蝉	侃侃而谈
一得之功	丰功伟绩
克制	放纵
精神	物质
山	水
正襟危坐	威义不肃
毁家纾难	损公肥私||自私自利
病入膏肓	妙手回春||手到病除
福过灾生	否极泰来
貌合神离	抵足而眠||齐心协力||势合形离||心有灵犀一点通||患难与共||心心相印||志同道合
开掘	埋藏
在所不惜	敝帚自珍
肥田沃土	寸草不生
蹉跎岁月	分秒必争||一寸光阴一寸金||夜以继日
诘屈聱牙	琅琅上口
亲人	仇人
油然而生	漠然置之||戛然而止
扩军	裁军
一清二楚	不明不白||扑朔迷离
劫后余生	洪福齐天||吉人天相
无精打采	发扬蹈厉||慷慨激昂||兴高采烈||神采奕奕
心灵手巧	笨手笨脚
好学不倦	一曝十寒
十拿九稳	漏洞百出
下里巴人	阳春白雪||曲高和寡
维持	改变
奴才	主子
一举两得	鸡飞蛋打||事倍功半||得不偿失||因小失大
抑	扬||扶
问心无愧	悔恨交加||问心有愧||心中有愧||无地自容
想入非非	四平八稳
千丝万缕	一刀两断||蛛丝马迹
素不相识	一见如故
黑白分明	不分青红皂白||颠倒黑白||一丘之貉||不分皂白||若隐若现||鱼龙混杂
感慨系之	无动于衷
食言	守信
面目一新	依然如故
掌上明珠	束之高阁
杀人如麻	救死扶伤
纸醉金迷	质朴无华||粗茶淡饭
不衫不履	规行矩步||衣冠楚楚
避而不谈	滔滔不绝
雅	俗
拔高	压低
不义之财	不谋私利||劳动致富
高歌猛进	裹足不前||垂头丧气
殊途同归	南辕北辙||背道而驰
赞誉	谴责
声泪俱下	笑容可掬
沉痛	欢快
情同手足	势如冰炭
体贴入微	漠然置之
遇险	脱险
关怀备至	漠不关心
锋芒逼人	闪烁其辞
残羹冷炙	山珍海味
名垂青史	声色狗马||遗臭万年
残兵败将	人强马壮||百万雄师
黔驴之计	力大无穷||神通广大
大气磅礴	气息奄奄||势单力薄
学	教
艰难竭蹶	家给人足||丰衣足食
身强力壮	骨瘦如柴||身心交病||弱不禁风
裁减	增补
屡见不鲜	百年不遇||盖世无双||登峰造极||千载难逢
十全十美	白圭之玷||美中不足||一鳞半爪||一无是处||金无足赤，人无完人
情深意重	深恶痛疾
一隅之见	远见卓识||真知灼见
邪门歪道	光明磊落
吞吞吐吐	畅所欲言||开门见山||指天画地||滚瓜烂熟||直言不讳
怡然自得	黯然销魂||百无聊赖
新秀	元老
安营扎寨	班师回朝||拔寨起营
俄顷	良久
黯然失色	不相上下||光彩夺目||动人心弦||目光炯炯
打家劫舍	道不拾遗||劫富济贫||绿林好汉||乐善好施
过犹不及	恰到好处||适可而止||不疾不徐||恰如其分
旷日持久	计日程功||稍纵即逝||电光石火||立竿见影
看破红尘	天伦之乐
糟蹋	爱惜||保护
小心翼翼	掉以轻心||视同儿戏||粗心大意||毛手毛脚
一往无前	故步自封||溜之大吉||趑趄不前||固步自封
漠不关心	关怀备至||仁至义尽||无微不至||息息相通||嘘寒问暖||宾至如归||满腔热枕||息息相关||休戚相关||血肉相连
弹丸之地	地大物博||地广人稀
男欢女爱	争风吃醋
势均力敌	天差地别
辅音	元音
表里如一	华而不实||色厉内荏||阳奉阴违
经销	采购
晓行夜宿	游山玩水
灵通	闭塞
寡不敌众	旗鼓相当
一了百了	依然如故
枯涩	流畅
一刀两断	纠缠不清||难解难分||千丝万缕||依依不舍||拖泥带水
嘉奖	惩罚||惩处
人困马乏	生龙活虎
关押	释放
片纸只字	累牍连篇
私人	公家
眉飞色舞	垂头丧气||愁眉苦脸
心甘情愿	强人所难||死不瞑目||抱恨终天||死不甘心||万不得已
局促	宽绰
顺	逆
主攻	助攻
常备不懈	临渴掘井||麻痹大意||放松警惕
前车可鉴	重蹈覆辙
草菅人命	为民除害
虚怀若谷	目空一切||唯我独尊||自高自大||一意孤行
缔结	取缔
立此存照	空口无凭
心狠手毒	心慈手软
七上八下	心安理得
安如泰山	不可终日||生死存亡||危如累卵||风雨飘摇||九死一生||土崩瓦解
斩尽杀绝	养虎遗患||养痈遗患||放虎归山||养痈成患
柔软	僵硬
无拘无束	局促不安
大公无私	患得患失||利欲熏心||唯利是图||徇私舞弊
蛮横无理	一团和气
秉烛夜游	彻夜苦读
东	西
祸	福
萧条	繁华
终了	开始
眼观六路	闭目塞听
心直口快	口蜜腹剑||闪烁其辞
不知不觉	惊天动地
厉	荏
无形	有形
暴虐	仁慈
强词夺理	不由分说||理直气壮||不言而喻||通情达理
泪如雨下	笑逐颜开||眉开眼笑
闻所未闻	司空见惯
神志清醒	昏头昏脑
昂首望天	眼睛向下
回笼	出笼
求战	求和
地狭人稠	地广人稀
天各一方	近在咫尺||形影不离||难分难解
民不聊生	安居乐业||国泰民安
听之任之	因势利导
千叮万嘱	寡言少语
不出所料	出人意表||出其不意
臭名昭著	大名鼎鼎||驰名中外
热心	冷漠
诚惶诚恐	处之泰然
挑肥拣瘦	饥不择食||先人后己||不择食||舍己为人
堂堂正正	鬼头鬼脑
缘木求鱼	瓮中捉鳖||探囊取物
不远千里	近在咫尺
半途而废	持之以恒||坚持不懈||锲而不舍||滴水穿石
批发	零售
人尽其才	大材小用||任人唯亲
寒	暑||暖
千方百计	无计可施||束手无策
绰绰有余	入不敷出||捉襟见肘
彼竭我盈	迎风而行
拒之门外	来者不拒||有求必应
炎	凉
戛然而止	油然而生
泰然处之	哭笑不得||寝食不安||食不甘味||神思恍惚
相忍为国	针锋相对
亮堂堂	黑洞洞||黑糊糊
藐视	重视||敬仰
怒不可遏	心平气和
破约	守约
笨手笨脚	手疾眼快||心灵手巧
鼠窃狗盗	正人君子
移山倒海	温文尔雅
通情达理	不近人情||不省人事||强词夺理
繁多	稀少
退却	前进
真才实学	不学无术||绣花枕头||才疏学浅
醉	醒
诚意	假意
变温动物	温血动物
宠辱若惊	宠辱不惊
楚弓楚得	楚才晋用
黄昏	清晨
毁	护
贪污腐化	清正廉洁
拆	装||拼
吝啬	慷慨||大方
洞烛其奸	制造冤案||不明真相
举棋不定	当机立断||坚忍不拔||死心塌地||坚定不移
明争暗斗	肝胆相照||推诚相见
改弦易张	旧调重弹
不近人情	合情合理||通情达理||入情入理
著作等身	胸无点墨
取而代之	一如既往
内勤	外勤
言之凿凿	无稽之谈||信口开河||信口雌黄
一改故辙	一成不变
游移不决	当机立断
表扬	批评
峭拔	平缓
茂密	稀疏||枯萎||凋零||稀疏
搅浑	澄清
轰轰烈烈	死气沉沉
源清流洁	上行下效
苦头	甜头
忧国忧民	祸国殃民
负约	践约
改邪归正	歧路亡羊||执迷不悟
孑然一身	成群结队
滾热	冰凉
赞扬	责难
正点	误点||晚点
暗地里	明面上
闭塞	畅通||灵通
引经据典	信口开河
切中要害	隔靴骚痒||隔靴搔痒
纵声大笑	泪如泉涌
寒带	热带
落第	中举
目不窥园	心猿意马
拍案叫绝	众口交谪
不得不发	盘马弯弓
妻离子散	破镜重圆||欢聚一堂
同仇敌忾	亲痛仇快||同室操戈
朋比为奸	反戈一击||同心协力||群策群力
蜗行牛步	风驰电掣||兔起鹘落
横	竖||纵
刁悍	仁慈
无名小卒	超尘拔俗||风云人物||如雷贯耳||英雄豪杰||超凡入圣||赫赫名流||树大招风||英雄好汉
下意识	有意识
干净	肮脏
素昧平生	莫逆之交||刎颈之交
如法炮制	别出心裁||独树一帜||独出心裁
强健	瘦弱
慈悲为怀	赶尽杀绝
发奋图强	纨绔子弟
五谷丰登	颗粒无收
脱离	联系||皈依
离题	扣题
精神焕发	没精打采||有气无力||筋疲力尽
如履薄冰	如履平地
招	挥
懊丧	昂扬
长远	眼前
狡兔三窟	坐以待毙
集思广益	独断专行||一意孤行||闭门造车
宽裕	穷困||拮据
取胜	失败||失利
众口交颂	怨声载道
敦厚	奸诈||刁滑
摇头	点头
播	收
独	偶
不堪设想	相安无事||安然无恙
单纯词	合成词
洞察一切	一窍不通||盲人摸象||一无所知
西方	东方
大惑不解	豁然贯通
让	争
人声鼎沸	万籁无声||夜阑人静||鸦雀无声
强化	削弱
当选	落选
心领神会	茫然不解
愚者千虑，必有一得	必有一失||智者千虑
假意	诚意||真情
灭火去薪	扬汤止沸
踌躇不前	奋起直追||毅然决断
责难	赞扬
俭朴	豪华||奢华
万马齐喑	百家争鸣||万马奔腾
墨守成规	朝三暮四||匠心独运||推陈出新||通权达变
惨不忍闻	喜闻乐见
复仇	报恩
立竿见影	旷日持久||盘马弯弓||无济于事||水中捞月
记挂	忘却
挂一漏万	面面俱到||万众一心
克尽厥职	玩忽职守
遣散	召集
无人问津	大有人在
事必躬亲	无所用心||坐而论道||好吃懒做
贪生怕死	出生入死||奋不顾身||前仆后继||舍生取义||视死如归||万死不辞||舍死忘生||同归于尽
刎颈之交	素昧平生
天旋地转	安安静静
公平	偏心
巧取豪夺	秋毫无犯||路不拾遗
失调	协调
私下	公开
铩羽而归	锐不可当
一无所知	洞察一切||如数家珍||心中有数||无所不知||众所周知
没精打采	精神焕发||神采奕奕
完聚	离散
深思熟虑	不假思索
无往不胜	屡战屡败
艰涩	流畅
绳锯木断	虎头蛇尾||有头无尾
开朗	狭窄
远虑	近忧
浅露	含蓄
力不从心	力所能及||量力而行
半斤八两	春兰秋菊||判若两人||千差万别
大祸临头	喜从天降
鲁莽行事	见机而作||见几而作||见机行事
彬彬有礼	出言不逊||专横跋扈
突飞猛进	江河日下||以退为进
金玉良言	流言蜚语||欺人之谈
制造冤案	洞烛其奸
藏污纳垢	藏龙卧虎
落榜	登第
飞黄腾达	江河日下||日暮途穷
死有余辜	功标青史||死得其所
反动	进步
绿	红
仰承鼻息	不以为然
一言既出，驷马难追	言而无信
历届	应届
佃	租
旁证	主证
装	拆
衰	盛
邋里邋遢	一干二净
全豹	一斑
瑰宝	粪土
自为阶级	自在阶级
冰点	沸点
睚眦必报	大度包容
跃然纸上	刻鹄类鹜||画虎类犬
苛求于人	反求诸己
笨重	轻巧||灵巧||轻盈
纬	经
赚钱	赔本
闭门思过	不思悔改
贫困	丰裕
单弱	结实
隆起	塌陷
淬火	退火
旧教	新教
不相为谋	切磋琢磨
沉郁	舒畅
显赫	卑微
毒草	香花
火热	冰冷||寒冷
撤职	任命
衰老	健旺||年轻||强壮
仗义直言	飞短流长
反对	拥护||赞成
主观	客观
食不果腹	酒足饭饱
妖魔鬼怪	麟凤龟龙
发挥	压抑
谜面	谜底
主要	次要
浊音	清音
优良	低劣||恶劣
承前启后	空前绝后
连种	轮种
胜诉	败诉
敢说敢做	道路以目
低落	高昂||高涨
出售	购买
癣疥之疾	心腹之患
其味无穷	味同嚼蜡
立正	稍息
解职	复职
针插不入	见缝插针
天堂	地府||地狱
求	供
内容	形式
方寸之地	五湖四海
从前	现在
推心置腹	居心叵测||甜言蜜语||虚与委蛇||尔虞我诈||巧言令色
输出	输入
早熟	早衰
储存	动用||支取
声东击西	围魏救赵
挺立	倒伏
如雷贯耳	无名小卒
备取	正取
闭幕词	开幕词
干乎乎	稀溜溜
暂时	长久
混淆是非	是非分明||明辨是非
隐晦	鲜明
白壁微瑕	白璧无瑕
偷懒	卖劲
徇情枉法	大义灭亲
假象	真相
持械	徒手
变速运动	匀速运动
拘谨	随便
笑容	愁容
残枝败柳	繁花似锦
功成不居	居功自傲
恶化	好转
俗人	僧徒
私费	公费
迎风而行	彼竭我盈
残忍	仁慈
沉重	轻快
瘦弱	强健||壮健
下马观花	蜻蜓点水
右	左
任其驰骋	画地为牢
歪门邪道	康庄大道||正人君子||不二法门
山盟海誓	见异思迁
不相往来	息息相通
知多见广	孤陋寡闻
掌上珠	肉中刺
痴学不悟	不经一事，不长一智
酒色之徒	正人君子
不过尔尔	不同凡响
完好	残破
严肃认真	肤皮潦草
疏	亲||密
不务正业	奋发有为||埋头苦干
三十六策，走为上策	坐以待毙
功标青史	死有余辜
开头	结尾
鲸吞	蚕食
富商巨贾	小康之家
咎有应得	积善得果
谬论	公理
难听	好听||悦耳||中听
懒惰	勤快||勤勉
销售	采购
认认真真	毛手毛脚||淡然处之||马马虎虎
精神饱满	穷极无聊
节俭	糜费||铺张
支吾其词	侃侃而谈
男	女
面目全非	依然如故
如兄如弟	如狼似虎
胜仗	败仗
嫉贤妒能	求贤若渴
包而不办	垂帘听政
丢人	光彩
神色不惊	心有余悸||心惊肉跳
悲欢离合	平淡无奇
零敲碎打	一气呵成
猴头猴脑	虎头虎脑
深	浅
圣主	暴君
必有一失	愚者千虑，必有一得
福	祸
官绅	布衣
德高望重	无名鼠辈||声名狼藉
永不相见	重温旧梦
个人	集体||团体
薄暮	拂晓
有趣	乏味
省	费
自愿	强迫
承受	施加||推却
打躬作揖	横行霸道
有用	有害
高级	低级
填房	元配
取消	制定
休息	工作
抬高	贬低
鸣锣开道	无声无息
分内	分外
灾星	福星
水到渠成	功败垂成
战书	降表
侧面	正面
听其自然	因势利导
瑜不掩瑕	瑕不掩瑜
急风暴雨	和风细雨
节外生枝	万事大吉||一帆风顺
富有	贫苦||贫穷
非	是
好感	反感
东摇西摆	稳如磐石
凝滞	流动
应对如流	瞠目结舌
长途	短途
上任	下任
藐藐	谆谆
老师	学生
作茧自缚	嫁祸于人
精细	粗疏||粗糙
起笔	煞笔
举手之劳	难于登天
揭露	蒙蔽||掩盖
久留	暂停
推卸	担负
风华正茂	风烛残年||桑榆暮景
坏处	好处
心事重重	无忧无虑
崇山峻岭	一马平川
穷年累月	一朝一夕||顷刻之间
平凡	杰出
今音	古音
薄弱	牢固||雄厚||强大
门当户对	井浅河深
还俗	出家
大年	小年
游山玩水	晓行夜宿
主子	奴才
空瘪	饱满
捧场	拆台
凶神恶煞	好好先生||一团和气
大	小
赏	罚
真	假
鸟语花香	穷乡僻壤
颂古非今	后今薄古
忌日	生日||寿辰
战败	战胜
收买	出卖
反目	和好
进化	退化
屡教不改	幡然悔悟||浪子回头
流传	失传
恭敬	轻侮
稀客	常客
顺道	专程
忠厚	奸猾||狡猾
真实	虚假||虚拟
得胜班师	抱头鼠窜
死得其所	死有余辜
粗大	纤小
天	地
事在人为	听天由命
一日之雅	八拜之交
敬礼	还礼
心口不一	笑里藏刀
关外	关内
优	劣
大大方方	蹑手蹑脚
中学	西学
唱主角	跑龙套
头	尾
赐	乞
彪形大汉	白面书生
收市	开市
血口喷人	反躬自问
目	纲
繁难	简易
良辰美景	月黑风高
消亡	生长
孤苦伶仃	天伦之乐
孤家寡人	群威群胆
豪华	俭朴
富可敌国	小本经营
反唇相稽	无言以对||哑口无言
恶臭	芳香
狭窄	开朗||宽绰||辽阔||宽阔||宽阔
销	产
突起	沉陷||洼陷
布施	化缘
穴居野处	豪华居室
设防	撤防
无奇不有	平淡无奇
灵牙利齿	笨口拙舌
赞许	责怪
干瘦	肥胖
糟粕	精华
气贯长虹	气息奄奄
不入虎穴，焉得虎子	胆小如鼠
舍本逐末	追本求源
守财奴	败家子
综合	分析||分解
流失	保持
清楚	隐约||模糊
众口交誉	啧有烦言
接收	交出
独立自主	不由自主
烟雾弥漫	烟消云散
营私舞弊	徇私舞弊
被告	原告
近忧	远虑
稳定	波动
英姿焕发	獐头鼠目
开口	住口
气冲斗牛	心平气和
前辈	后代
学非所用	学以致用
豪门大族	小康之家
败笔	绝唱
开战	休战
白头偕老	分道扬镳
每日	间日
协调	失调
开盘	收盘
咫尺之间	天涯海角
小心	大意
细小	洪大||巨大
大地	苍天
巧妇难为无米之炊	指雁为羹
他杀	自杀
软弱	刚强
一点论	两点论
人老珠黄	徐娘半老
苦大仇深	养尊处优
一元论	多元论
镇静自若	六神无主||丧魂落魄
精致	简陋||粗糙
财迷心窍	拾金不昧
拙劣	高超
自以为是	博采众长
上马	下马
拖欠	偿还
雄心壮志	万念俱灰
革除	留用
乞浆得酒	得不偿失
千虑一得	千虑一失
对立	同一
疑心生鬼	深信不疑
来日	往日
退伍	服役
高深	浅薄
拾	弃
冰壶秋月	雕心雁爪
赊销	赊购
违法	守法
热闹	安谧||寂静||冷清
五光十色	色彩单一
道不拾遗	打家劫舍
干巴巴	湿漉漉
老式	新式
举世无双	无独有偶
收方	付方
无可救药	药到病除
无方	有方
童	叟
私产	公物
慷慨悲歌	如泣如诉
旧	新
单独	共同||结伴
安分	捣乱
减退	增进
一箭之遥	天涯海角
响彻云霄	闷声不响
兴旺	没落||衰败
务虚	务实
浅见	卓见
搅混	澄清
助攻	主攻
暮色	曙光
升级	降级
滔滔	涓涓
朱文	白文
不谋私利	不义之财
高歌	低吟
仰之弥高	如履平地
爬行	跃进
部分	全部||全体||整个
相敬如宾	敬而远之
一网打尽	一介不取
决赛	预赛
爪牙之将	虾兵蟹将
千岩万壑	一马平川
屏气凝神	心不在焉
外面	里面
偷梁换柱	光明磊落
军卒	将校
暂行	正式
卖	买
长命百岁	一命呜呼
不文不武	得心应手
正面人物	反面人物
驴鸣狗吠	一唱三叹
白话	文言
后会难期	后会有期
谎言	事实
一代风流	一代奸雄||遗臭万年
振奋	颓废
军港	商港
聚	散
解	扎
头午	过午
责有攸归	漠不相关
日晕	月晕
鄙夷	景慕||敬佩
废	宝
粗糙	光滑||光润||滑腻||细嫩
神色自若	惊慌失措||呆若木鸡||手足无措
水灵	干巴||干枯
空话	实话
卵与石斗	以一当十
虚己以听	唯我独尊
捷足先登	姗姗来迟
启用	查封
用兵	养兵
安适	艰难||艰辛
阴历	阳历
软	硬
开通	守旧||迂腐
母	公
慎重	轻率||随便
背＃	当众
欢快	沉痛||沉重
硬梆梆	软绵绵
消极	积极
选贤任能	招降纳叛
天然	人造
脍炙人口	平淡无味
早霞	晚霞
不时之需	一定之规
休会	复会
净	毛||脏
青云直上	一落千丈
幼年	成年
素淡	浓艳
心如刀绞	心满意足
宾词	主词
玉石俱焚	两全其美
婆家	娘家
慷慨解囊	一毛不拔
其势汹汹	心平气和
邪路	正路
喜欢	腻烦||讨厌||厌烦
受穷	发财
和缓	锋利||紧张||强硬
一览无遗	略见一斑
母系	父系
喜色	怒容
老搭当	新伙伴
不期而然	意料之中
管鲍之交	点头之交
削弱	增强||巩固||加强||强化
绿灯	红灯
振振有词	闭口不言
随和	执拗
敌国	盟国
明码	暗码
无衣无食	饱食暖衣
后台	前台
间接	直接
统购	统销
神经过敏	麻木不仁
私邸	官邸
按劳分配	无功受禄
抚掌大笑	悲痛欲绝
下面	上面
主动	被动
善良	恶毒||凶狠||阴险||凶恶
头晌	过晌
过目不忘	视而不见
得道多助	失道寡助
批驳	辩护
谎话	真话
已然	未然
正事	闲事
以外	以内
简单	详细||复杂
生还	覆灭
安全	危险
愚蠢	聪慧||聪明||乖觉
初生牛犊不怕虎	胆小怕事
百步穿杨	无的放矢
简练	罗唆
集体	个人
仗义疏财	爱财如命||一毛不拔||谋财害命
划分	合并
升值	贬值
活期	定期
下降	上升
理科	文科
蹈常袭故	除旧布新
迟钝	尖锐||灵敏||锐敏||敏捷
师傅	徒弟
化	凝
父母	子女
丰厚	菲薄
热热闹闹	冷冷清清
得意洋洋	垂头丧气
吸取	摈弃
工作	休息
高贵	卑贱||低贱||轻贱||微贱||下贱
失	得
冰雪消融	冰天雪地
说服	压服
成品	原料
拔营	安营
农历	公历||西历
新朋	旧雨
报忧	报喜
狼吞虎咽	细嚼慢咽
持续	间断||中断
难偿所愿	如愿以偿
怒气冲天	欣喜若狂
检举	包庇
惊弓之鸟	初生牛犊
轻狂	恭谨
凶兆	祥瑞
脚踏实地	白日做梦||蜻蜓点水||纸上谈兵||好高骛远
干脆利落	首鼠两端
序曲	尾声
自鸣得意	自怨自艾
应聘	征聘
家财万贯	家贫如洗||家徒四壁||一贫如洗
混为一谈	是非曲直
月底	月初
多见少怪	少见多怪
谗言	忠言
脚痛医脚	正本清源
千辛万苦	娇生惯养
健全	欠缺
安抚	弹压||讨伐||镇压
雷打不动	含冤负屈
真理	谬误||邪说||谬论
因噎废食	百折不挠
驾轻就熟	半路出家
泄密	保密
增强	减弱||削弱
耳闻目睹	闭目塞听
歪歪斜斜	端端正正
净化	污染
全局	本位
慢慢腾腾	急急忙忙
游击队	正规军
退出	参加
忘却	记挂
下跌	升涨
还债	借债
骄傲	气馁||谦虚
赞叹不已	人言啧啧
申讨	声援
逍遥自在	胆战心惊||提心吊胆
装模作样	本来面目
欢＃	欢送
恩	怨
人之常情	不尽人情
言犹在耳	置之脑后
改天换地	听天由命
忘	记
奴隶	自由民
有意识	无意识||下意识
快	迟||慢
洗心革面	顽固不化
安稳	动荡
踽踽独行	成群结队
素	荤||艳
有目共睹	有目无睹
和睦	勃谿
自由诗	格律诗
尖细	粗重
雅人深致	俗不可耐
置疑	置信
退	定||进
确切	含糊
一成一旅	千军万马
疥癣之疾	肘腋之患
战战兢兢	胆大妄为
深谷	高峰
同恶相济	反戈一击
同居	分居
副食	主食
寻事生非	善罢干休
难过	好过||高兴
入帐	销帐
捷径	弯路
丰收	荒歉||歉收
自由	纪律
乱世	盛世
遵守	违犯
高	低||矮
各个击破	腹背受敌
排忧解难	煽风点火
伟大	渺小
倒运	走运
减低	增高
悭吝	慷慨
死里求生	坐以待毙
直译	意译
认贼作父	泾渭分明
闭卷	开卷
雕梁画栋	蓬门荜户
先天	后天
奸诈	敦厚
韦编三绝	偶一为之
考	妣
虚名	实学
工整	潦草
退还	索取
井然	混乱
污泥浊水	清澈见底
苏醒	晕厥
肥胖	干瘦
天才	蠢材||庸才||庸人
破戒	受戒
从犯	主犯
早晨	晚上||傍晚
苦口婆心	口蜜腹剑
客人	主人
新交	故人||旧交
起头	末了||扫尾
彪炳千古	烜赫一时
胡搅蛮缠	知情达理
地表	地心
赢	输
净利	毛利
凶多吉少	吉星高照
羽毛丰满	羽毛未丰
憎恶	钟爱||疼爱
同生共死	你死我活
交口称誉	啧有烦言
支持	抵制
强奸民意	顺天应人
递减	递加||递增
高雅	粗鄙
使用	废弃
以上	以下
罪恶	功勋
浪费	节省||节约
摩肩接踵	地广人稀
无懈可击	破绽百出||无孔不入||有机可乘||七拼八凑
偏私	公正
疏忽	周到
显亲扬名	斯文扫地
卯眼	榫头
将功补过	将错就错
雾里看花	一目了然
维护	危害||破坏
旭日	落日
自己	他人
星罗棋布	寥若晨星
宾	主
怒骂	嬉笑
歪歪扭扭	直直溜溜
慌	稳
淡	咸
德薄能鲜	德才兼备
败事	成事
盈利	亏空||蚀本||折本
离心力	向心力
欲速则不达	一蹴而就
现象	本质||实质
百炼成钢	娇生惯养||一人传虚，万人传实
迟疑	果决
公转	自转
一息尚存	寿终正寝
失职	尽职
静	动
合伙	拆伙
凉快	暖和
摇身一变	一成不变
激流勇进	急流勇退
皱	平
尔虞我诈	开诚布公||披肝沥胆||推心置腹
顶天立地	瞻前顾后
倚老卖老	老当益壮
题花	尾花
常态	变态
禁止	容许||允许
撑	塌
坚强	脆弱||柔弱
内心	外貌
区分	混同
拒人千里	三顾茅庐
狡猾	忠厚
晋升	贬黜
公用	自用
累赘	扼要
原因	结果
胆战心惊	逍遥自在
缺德少才	才高行洁
贺喜	吊丧
义无返顾	裹足不前
持而	酷爱
整	零
积善得果	咎有应得
梢	本
一念之差	千差万别
言教	身教
单口	对口
去世	出世
休学	复学
顺从	顶撞||反抗||反对
可信	可疑
前无古人	司空见惯
口头	书面
才疏志浅	才高八斗
精干	庞大
诽谤	颂扬
非分之想	自知之明
变卖	购置
正门	旁门
物美价廉	米珠薪桂
惦记	淡忘||放心||忘记
弱小	强大
新陈代谢	停滞不前
扩展	减缩||简缩
慈眉善目	青面獠牙||暴戾恣睢
温和	粗暴||急躁||暴躁||凶狠||严厉
满屋尘灰	窗明几净
平静	沸腾||动荡||激动||喧闹
发迹	破产
外勤	内勤
先声夺人	甘拜下风
陌生	熟识||熟悉
国色天香	其貌不扬
缓慢	迅速||赶快||快速
合成词	单纯词
先	后
起点	终点
头目	喽罗
城	乡
熄	着
成绩	过失
抑强扶弱	以强凌弱
止	起||行
石破天惊	默默无闻
悦服	慑服
如获至宝	如丧考妣
油腔滑调	一本正经||不苟言笑
大声喧哗	交头接耳
扩散	清除||聚集||集中
升起	降落||落下
开业	停业
平稳	颠簸
搜索枯肠	无所用心
无机可乘	有机可乘
过时	时兴||行时||应时
谢绝	领受
刻鹄类鹜	跃然纸上
指示	请示
穷巷拙门	洞天福地
附录	正文
正午	午夜
短暂	漫长
片面	全面
守信	食言
痴情	负心
韵	声
松散	紧凑||严密
谬种流传	流芳百世
反	正
上火	去火
砥柱中流	独木难支
大开眼界	鼠目寸光
弥合	破裂
做客	做东
上	下1
棘手	顺手
立杆见影	海底捞月
爱莫能助	爱屋及乌
主人	宾客||客人||奴仆||仆人
风雨飘摇	安如泰山||稳如泰山||岿然不动
阻拦	放行
恩断义绝	难兄难弟
亲与其事	坐观成败
功成名遂	身败名裂
寡	众
沧海一粟	恒河沙数
温情脉脉	冷若冰霜
在职	离休||退休
宽大	窄小
羞与为伍	引以为荣
止于至善	毫无是处
弄璋	弄瓦
过错	功绩
报恩	复仇
天下为家	天下为公
万古不变	万象更新
侵犯	保卫||保障
笨鸟先飞	坐以待毙
购买	出售
雅致	俗气
本义	转义
掩蔽	暴露
中举	落第
暮年	童年
威义不肃	正襟危坐
充足	短缺||缺少||缺乏
尖酸刻薄	温柔敦厚
长调	小令
决一雌雄	不分胜负
头等	次等
出	入
露天	室内
舍死忘生	贪生怕死
先来后到	惩前毖后
祖	孙
顽固	开明
联合	分散
歉	丰
起动	关闭
吸	呼
绕口	顺口
噪音	乐音
陈旧	簇新
静若秋水	震撼人心
暗地	公然
春风得意	向隅而泣
人家	自家
裁军	扩军
正	倒||反||副||偏||枉||误||斜||邪
对答如流	答非所问
答	问
乾	坤
呆板	活泼||灵活
三五成群	形单影只||风流云散
墨	朱
热烘烘	冷飕飕
花花公子	白面书生
母语	外语
惹火烧身	明哲保身
暗室欺心	不欺暗室
增补	裁减||删节
名存实亡	名副其实
治本	治标
才华出众	樗栎庸材
重温旧梦	永不相见
诿过于人	推己及人
损耗	补偿
浅薄	高深||渊博
坏人	好人
功和	挑拨
罗嗦	利落
满	空
埋没	发现
凶恶	慈善||善良||善良
私而忘公	公而忘私
闭门造车	集思广益
泰山压卵	螳臂当车
明眸皓齿	青面獠牙
昭然若揭	真伪莫辨
分而为二	合而为一
大梦初醒	魂牵梦萦
忧愁	快活
开卷有益	读书无用
冷淡	热烈||热情
竖	横
可喜	可恶
递交	接受
一团漆黑	了如指掌
虚心	自是||骄傲
百废待兴	百端待举
怀疑	坚信||相信
远见卓识	一隅之见
愤世嫉俗	安贫乐道
不进则退	勇往直前
浮	沉||潜
误点	正点
早	晚
一文不值	一字千金||无价之宝
手不释卷	不学无术
簇新	陈旧
窄	广||宽
权利	义务
无德无才	郎才女貌
取缔	缔结
一封家书	石沉大海
曲里拐弯	直不笼统
暴躁	柔顺||温顺
扪心无愧	问心有愧
喋喋不休	三言两语
写实	虚构
本名	诨名||外号
背	面
熟视无睹	过目成诵
契友	死敌
陆	水
繁	简
座上宾	阶下囚
欢实	蔫巴
改革	沿袭
青出于蓝	不可企及
阴差阳错	千真万确
感慨万千	无动于衷
少量	大量
鲜为人知	妇孺皆知
边疆	内地
鲍鱼之肆	芝兰之室
雄	雌
演绎	归纳
分解	化合
辞职	就职
拾金不昧	财迷心窍||敲诈勒索
虚弱	康健||强壮
当之无愧	当之有愧
召集	遣散
晦涩	畅达||流畅||晓畅
百孔千疮	气象万千
凝结	蒸发||离散||溶解
仰望	鸟瞰||俯视
人面桃花	长相厮守
野调无腔	文质彬彬
花残月缺	花好月圆
绝代佳人	青面獠牙
详	略
沉稳	轻佻
微言大义	空洞无物
偏心	公道||公平
缔约	解约
大发雷霆	平心静气
千疮百孔	天衣无缝
农忙	农闲
叛国	报国
灭顶之灾	洪福齐天
赐予	乞求
本家	外姓
凋谢	开放||盛开
债户	债主
抄袭	独创
鸿毛	泰山
顺便	特意||专门
解脱	缠绵
甜津津	苦咧咧||苦巴巴
旺季	淡季
惟妙惟肖	画虎类犬
担惊受怕	稳如泰山
理屈辞穷	义正辞严
作威作福	仁至义尽
迂回曲折	一泻千里
少年老成	少不更事
滞销	畅销
历史唯心主义	历史唯物主义
有色金属	黑色金属
台下	台上
见面	分别
实至名归	沽名钓誉
疏导	堵塞
愉快	郁悒||悲伤
可爱	可恨||可憎||讨厌
成仁取义	苟且偷生
简洁	冗长
起锚	抛锚||下碇
衣钵相传	以讹传讹
假嗓	真嗓
深居简出	出头露面
还价	要价
干渠	毛渠
超尘拔俗	芸芸众生||无名小卒
积累	消耗
恨入骨髓	情深似海
领先	落后
艰苦奋斗	花天酒地
广土众民	立锥之地
刺刺不休	沉默寡言
退赔	侵吞||侵占
领取	存放||寄存
劳	逸
签收	签发
拈轻怕重	任劳任怨||不辞劳苦||勇挑重担
只言片语	千言万语
先发制人	后发制人
刀山火海	风平浪静
下属	上峰
元老	新秀
团圆	失散
昂首挺胸	低眉顺眼
回顾	瞻望||展望
拱手相让	寸土必争
馋涎欲滴	淡泊寡味
出卖	收买
赊欠	预付
悠哉游哉	餐风露宿
大智大勇	有勇无谋
为富不仁	为仁不富
乡村	城市
有缘	无缘
尖酸	和婉
付方	收方
降	升
活	板||呆||死
春意阑珊	春意盎然
深得人心	不得人心
惨淡经营	无所用心
时乖命骞	福如东海
亲痛仇快	同仇敌忾
山清水秀	穷山恶水
粗俗	典雅||文雅
众目昭彰	掩人耳目
异花传粉	自花传粉
动产	恒产
宝刀不老	年老体衰
真诚相待	虚与委蛇
厌恶	爱好||爱怜
咬牙切齿	笑容可掬
友	仇
直	屈||弯
肥	瘦
疏远	密切||亲近
攻势	守势
朔	望
前车之鉴	重蹈覆辙
吸引	排斥
赔本	赚钱
保留	割除||解除
年初	年底||年末||年终
低人一等	高人一等
哀悼	欢庆
灵巧	笨拙||笨重
离经叛道	三纲五常
香消玉殒	健康长寿
五内俱焚	心花怒放
奉	违
贬斥	嘉许
人外有人	无以复加
无介于怀	耿耿于怀
万马奔腾	万马齐喑
富贵	寒微
关注	漠视
畅通	闭塞||阻塞
简朴	奢侈||豪华
丢脸	露脸
小题大做	轻描淡写
压低	拔高
爱国	卖国
造作	自然
横眉立眼	和颜悦色
隐瞒	张扬
全脂	脱脂
黑夜	白昼
精耕细作	粗制滥造
真名	化名
优点	缺点||缺陷
落选	当选||入选
惩罚	嘉奖||奖励
亏损	盈余
开幕词	闭幕词
成	幼
香喷喷	臭烘烘
错	对
初亏	复圆
缺乏	丰富
厚颜无耻	自惭形秽
恶浊	清爽
放荡	检点
入超	出超
仁政	暴政
万人空巷	穷乡僻壤
不可开交	分崩离析
长久之计	权宜之计
故杀	误杀
前进	退却
牧主	牧工
眼睛向下	昂首望天
忍辱偷生	揭竿而起
血流漂杵	兵不血刃
寒门	权门||望族
铸成大错	痛改前非
贫嘴薄舌	沉默寡言
解冻	上冻
春雨绵绵	秋高气爽
朝晖	落照
敌人	人民||朋友
全文	提要||摘要
放开	收拢
十冬腊月	五黄六月
登第	落榜
收场	开场
切割	焊接
蚀本	盈利
唯物论	唯心论
进退有常	进退失据
探骊得珠	文不对题
背风	迎风
轻装简从	前呼后拥
空间	时间
诅咒、诋	歌功颂德
斗牛车薪	一针一线
容易	烦难||困难
七窍生烟	心平气和
混淆	澄清||划清
缓	速||急
隐约其辞	直言不讳
甘居人后	力争上游
慢腾腾	急匆匆
得天独厚	先天不足
归顺	背叛
唯心史观	唯物史观
处罚	奖赏
划算	吃亏
解散	集合
稀薄	浓密||浓厚||浓重
镇定	恐慌||惊慌||紧张||慌张
含混	明了
木本	草本
欣慰	伤感
人仰马翻	人强马壮
生疏	谙练||纯熟||熟悉||熟练
韧	脆
风云突变	一成不变
顺手牵羊	困难至极
毅然决断	踌躇不前
闲事	正事
城里	乡间
漆黑	雪白||明亮||光明
高尚	卑鄙||庸俗
丰年	荒年||歉年
山南海北	近在咫尺
乱臣贼子	忠君爱国
枪林弹雨	和平共处
密密麻麻	稀稀拉拉
讳疾忌医	激浊扬清
奇花异草	平淡无奇
慈	狠
往返	单程
宝山空回	满载而归
吃荤	吃素||吃斋
哄堂大笑	哑然失笑
轻慢	敬重
除	兴
因祸得福	乐极生悲
出师	班师||回师
文雅	粗鲁
仄声	平声
价值连城	一钱不值
是非不分	浊泾清渭
发出	收回
精明强干	碌碌无为
豪言壮语	唉声叹气
挥	招
救亡图存	闭关自守
普通	别致||特出||珍贵||特别
失当	适当
无家可归	安居乐业
洗雪	蒙受
雄才大略	雕虫小技||庸庸碌碌
长吁短叹	欢歌笑语
勇敢	怯弱||懦弱||怯懦||胆怯||胆小
陋俗	新风
息	作
东扶西倒	挥洒自如
见几而作	鲁莽行事
卑污	高洁
触类旁通	一窍不通
惨无人道	仁至义尽
伤风败俗	高风亮节
冰清玉洁	浅尝辄止||水性杨花
撤销	设置
朴素	华丽||奢侈
老实	淘气||顽皮||狡猾
舍下	府上
省事	费事
字斟句酌	离题万里||望文生义
列祖列宗	子孙后代
主	宾||奴||支2||仆
明白	糊涂||疑惑
后记	序言||引言
十字街头	穷乡僻壤
富裕	穷困||贫穷
暖色	寒色
迫害	拯救
速决战	持久战
饮泣吞声	前仰后合
辅车相依	反目成仇
游移	坚定
清晨	黄昏
夜不闭户	浑水摸鱼
兵来将挡，水来土掩	束手无策
推陈出新	安常守故||率由旧章||泥古不化||因循守旧||墨守成规||清规戒律
付诸东流	继日成功
宏观	微观
失时	及时
减	添||增||加
无意	成心||有意
蠢蠢欲动	按兵不动
名扬四海	臭名远扬
穷人	财主||富翁
眉目如画	其貌不扬
繁华	萧条||荒凉
绝处逢生	枯鱼之肆||走投无路||束手就擒||坐以待毙
转阴	放晴
超期	按期
冷冰冰	热乎乎
无所不有	一无所有
下级	上级
丢丑	争光
训练有素	半路出家
口服	心服
难如登天	轻而易举
雨过天青	大雨如注
万古千秋	一年半载
敲诈勒索	拾金不昧
光荣	耻辱
返回	离开
鸾翔凤集	劳燕分飞
唯物主义	唯心主义
依赖	独立||自立
通都大邑	穷乡僻壤
兵匪不分	匕鬯不惊
狡诈	淳厚
放心	顾虑||挂虑||挂牵
事出有因	平白无故
分手	会面
果断	踟蹰||踌躇
贻害无穷	斩草除根
汗马功劳	一事无成
聪敏	愚笨
祸福无门	命中注定
大户	小户
现代	古代
低＃	尊贵
中毒	解毒
利欲熏心	大公无私||克己奉公
冲口而出	守口如瓶
巧舌如簧	笨口拙舌
浪漫主义	现实主义
获救	丧命
丁一卯二	藕断丝连
繁忙	空闲||清闲
拖沓	爽利
仁人志士	害群之马
降低	提高||提升
嫌贫爱富	惜老怜贫
屡战屡败	马到成功||无往不胜||立于不败之地||所向无敌
享福	吃苦
众望所归	人心向背
次品	正品
减少	增添||增加
拨弄是非	排难解纷
信心百倍	心灰意冷
欢乐无涯	苦海无边
瑕	瑜
苦恼	高兴||甜美
并重	偏重
柔顺	暴躁
走南闯北	足不出户
国际主义	沙文主义
面红耳赤	面不改色
夜	昼
公演	预演
中国画	西洋画
铁打江山	改朝换代
守约	破约
暖锋	冷锋
赤贫	巨富
地支	天干
释放	关押||监禁||禁锢||拘捕||拘押||看押||囚禁||收集||收押||捉拿||回收
记得	忘记
强颜欢笑	忍俊不禁
功劳	罪过
近在眼前	远在天边
充实	空虚
日不暇给	无所事事
沙弥	方丈||高僧
时常	间或
纸老虎	真老虎
化装	卸装
瓜熟蒂落	欲速不达
过去	将来
塌实	发慌||浮漂
走马看花	下马看花
忘其所以	谦虚谨慎
父本	母本
旁系	嫡系
对外开放	闭关自守
稠人广座	荒无人烟
群众	骨干||领袖
人才济济	人才零落
口译	笔译
旗帜鲜明	模棱两可
卖身	赎身
进寸退尺	得寸进尺
方	圆
粗略	精确||详尽
戒酒	纵酒
投降	纳降
海内存知己，天涯若比	割席分座
长处	缺欠||短处
扎	解||拔
不名一钱	腰缠万贯
夭	寿
发人深省	执迷不悟
节节败退	捷报频传
有机	无机
客随主便	喧宾夺主
夕阳	朝阳
按图索骥	不落窠臼
昏	晨
捕	释
和衷共济	分庭抗礼
沉闷	活跃||轻松
有限	无穷||无限||无限
崭新	破旧||陈旧
逆来顺受	针锋相对
捶胸顿足	眉开眼笑
无妄之灾	安居乐道
谦逊	傲慢||高慢
犹豫	干脆||急切||果断
安眠	失眠
甜头	苦头
一以贯之	虎头蛇尾
高见	管见||拙见
粗	精||细
胎生	卵生
不忮不求	多多益善
攻打	防守
元音	辅音
嘈杂	宁静||肃静
东方	西方
失效	生效
剩余劳动	必要劳动
百万雄师	残兵败将
吞	吐
独具匠心	随声附和
良莠不齐	泾渭分明
全副武装	赤手空拳
来	往||去
称兄道弟	行同陌路
不近情理	通力合作
卑鄙龌龊	高风亮节
吃一堑，长一智	重蹈覆辙
一般	特殊
粗茶淡饭	山珍海错||纸醉金迷||山珍海味
馨香祷祝	口是心非
滴水成冰	汗流浃背
乞求	赐予||恩赐
擎天柱石	中流砥柱
改变	维持
隔靴骚痒	切中要害
拮据	充裕
顺耳	刺耳||逆耳
顺叙	倒叙
向阳	背阴
天渊之别	千篇一律||伯仲之间
低吟	高歌
配角	主角
好心	恶意
见所未见	司空见惯
上税	抗税
披坚执锐	赤膊上阵
亡	存
罪人	功臣
低价	高价
巧立名目	实事求是
停滞不前	斗转星移||马不停蹄||瞬息万变||新陈代谢||急起直追
冰凉	滾热||滾烫
公开	秘密||私下||隐蔽||保密
上行	下行
聘请	辞退
糟踏	珍惜
太阴	太阳
抛弃	迷恋||拾取
死而后已	虚度年华
夜＃	早点
麻麻亮	麻麻黑
养精蓄锐	竭尽全力
保守	变革||激进||泄露
钝	锐||尖
幸运	厄运
金迷纸醉	饥寒交迫
凡人	神仙||伟人
天摇地动	风平浪静
虐待	爱抚||优待
建立	废除||推翻
小孩	老人
赔	赚
停职	复职
珍视	蔑视
剜肉补疮	事半功倍
现实	幻想||理想
提前	延缓
出仕	归田||退隐
民	兵
望尘莫及	后来居上
还	该||借
驽马	骏马
受罚	受奖
油嘴滑舌	一本正经
吃苦耐劳	好吃懒做
合	离
违反	遵循
喜	愁||怒||厌
定居	流浪||游牧
施舍	募化||求乞
仓促行事	从长计议
私利	公益
制止	提倡
何乐而不为	迫不得已
亲	疏||干
暴露	藏匿||掩蔽||隐蔽
较短论长	同日而语
求援	援助
炉火纯青	半路出家
多情	薄情||无情
扶正	祛邪
安常守故	推陈出新
浑	清
分开	归并
借帐	还帐
扬汤止沸	釜底抽薪||灭火去薪
逆差	顺差
表层	深层
以力服人	以理服人
赃官	清官
肤浅	深刻||深透
杂牌儿	正牌儿
钳口不言	口若悬河
闷热	风凉||凉爽||清冷||清凉
明确	含糊
脑力劳动	体力劳动
茅塞顿开	冥顽不灵
失节	守节
天长地久	稍纵即逝
鲜有成效	卓有成效
大有靠山	无依无靠
意志消沉	精神抖擞
红日三竿	半夜三更
虚度光阴	马不停蹄
墨守陈规	标新立异
易	难
乐观	悲观
绝情寡义	恩重如山
起伏跌宕	平铺直叙
喜讯	噩耗
悬崖峭壁	坦荡如砥
客籍	祖籍
竣工	动工
受降	乞降
明知故犯	知过必改
开始	终结||终了||结束
扶起	放倒
鼠肚鸡肠	豁达大度
室内	露天
推脱	承担
仇人	亲人
喧闹	沉寂||寂静
压迫	反抗
门前冷落	熙熙攘攘
干燥	潮湿||湿润
急性	慢性
无孔不入	无懈可击
造谣	辟谣
幼稚	老练||成熟
天壤之别	相差无几
散装	集装||整装
细致	粗拉||毛糙||粗糙||马虎
勤劳	怠惰||懒惰
腐败	新鲜
负屈含冤	报仇雪恨
清淡	油腻
干净利落	拖泥带水
确数	约数
花枝招展	朴实大方
地下	天上
暗淡无光	云蒸霞蔚
枯	荣
模糊	明晰||清晰||清楚
无所适从	择善而从
椎心泣血	眉开眼笑
士兵	军官
伸展	蜷缩
重视	鄙薄||鄙视||忽视||藐视||轻视||无视
大材小用	人尽其才
谦辞	敬辞
麟凤龟龙	妖魔鬼怪
悔恨交加	问心无愧
藏	露
臭名	美名
夫唱妇随	情同陌路
夸奖	训斥
大型	微型
短浅	远大
部属	上司
购	售
含冤	申雪||昭雪
空谈	实践
张冠李戴	无可非议||毫厘不爽
放弃	采取
披头散发	眉清目秀
面生	面熟
首尾相应	横冲直撞
完好无损	残缺不全
杀人越货	舍己为人
万家灯火	灯火阑珊
掩耳盗铃	开诚布公
庶	嫡
归队	离队
顶礼膜拜	不以为然
浅酌低吟	引吭高歌
反驳	附和||赞同
勇士	懦夫
废物	宝物
伶俐	痴呆||笨拙
大笑不止	付之一笑
扩大	缩小
播弄是非	息事宁人
物质	精神
浮浅	透彻
邪说	真理
哑然失声	锣鼓喧天
风流潇洒	尖嘴猴腮
先入之见	放马后炮
南腔北调	字正腔圆
聪明才智	冥顽不灵
具名	匿名
郁结	排遣
异	同
盛年	残年
趋炎附势	刚正不阿
付之一笑	大笑不止
水运	陆运
放生	杀生
减轻	加剧||加重
悼词	贺词
漏网之鱼	瓮中之鳖
凝固	溶化
守旧	改良||革新||开通
悲	欢
明亮	暗淡||昏暗||曚昽
上报	下达
一刻千金	度日如年||一日三秋
足岁	虚岁
步步为营	轻举妄动
衰亡	兴起
收获	播种
剧烈	平和||轻微
一掷千金	一毛不拔
单薄	厚实
温血动物	变温动物
费解	易懂
虚伪	诚实
简明	烦琐
墓木已拱	尸骨未寒
粗劣	精良
缩	伸||涨
名垂千古	丑声远播
绸人广众	人杰地灵
后方	前方||前线
名满天下	身败名裂
徒慕虚名	循名责实
闷声不响	响彻云霄
怅然	欣然
胆大妄为	前怕狼，后怕虎||战战兢兢
混浊	澄澈||纯净
争执	和解
先知先觉	后知后觉
涤瑕荡垢	藏垢纳污
平白无故	事出有因
大煞风景	兴致勃勃
细节	梗概
收购	推销
龙困浅滩	饿虎扑食
来者不拒	拒之门外
教	学
丑陋	俊俏||美观||俏丽||秀丽
正房	配房||厢房
人间地狱	世外桃源
片甲不回	大获全胜
一言千金	人微言轻
不知所以	老马识途
寻章摘句	精挑细选
心急如焚	少安毋躁
内子	外子
后人	前人
近	远
奸	忠
昂扬	懊丧
出嫁	入赘
点头	摇头
嫁	娶
浅显	古奥||深奥
爱护	戕害||损害||荼毒
无本之木	源远流长
背后	当面
盘根错节	简明扼要
抗击	进攻
大有作为	无所作为
摧枯拉朽	坚不可摧
覆水难收	破镜重圆
公诉	自诉
淡薄	醇厚||深厚
本分	非分
断绝	恢复
记住	忘掉
滑	涩
抑制	兴奋||张扬
别具一格	千篇一律
独一无二	无独有偶
冷落	关心
脱身	缠身
人生地疏	轻车熟路
求同存异	求全责备
目不忍睹	目不暇接
沙哑	洪亮||清脆
以逸待劳	疲于奔命
抽象	具体
满额	空缺
万无一失	防不胜防
外行	内行||行家
小家碧玉	大家闺秀
以身作则	以身试法
绰约多姿	出乖露丑
昔	今
灭绝	滋生
白日做梦	脚踏实地
热	冷||凉
整齐	凌乱||杂乱
恒量	变量
富贵不能淫	见利忘义
抵抗	侵略||投降
死路	生路
三伏	头伏
拆除	敷设
毫无是处	止于至善
局部	大局
简本	原本
夜宵	早茶
做作	真率||自然
小气	大方
简便	麻烦
钦差大臣	奸贼死党
浓密	稀薄||稀疏
放松	加紧||抓紧
放飞	停飞
智勇双全	有勇无谋
尊敬	轻蔑
折线	直线
隐	现
静悄悄	闹嚷嚷
掩饰	流露
简陋	精致||豪华
下	上2
地狱	人间
郁郁不乐	兴高采烈
望月	朔月
以卵击石	避实就虚
持重	鲁莽
繁荣	凋蔽||衰败
胸中无数	心中有数
君子	小人
跑面	蹲点
虎头虎脑	猴头猴脑
寡闻少见	耳熟能详
自荐	推荐
昏迷	清醒
申斥	称誉
书香门第	蓬门荜户
优越感	自卑感
胸怀坦荡	包藏祸心
结合	分离
至高无上	等而下之
以德报恩	恩将仇报
区区小事	非同小可
穷	富
失掉	得到
从容	仓促||匆猝||慌忙||慌张
法网难逃	逍遥法外
唱	和
钝角	锐角
蠢笨	乖巧||巧妙
打开	封闭||关闭
两头	中间
旺月	淡月
水泄不通	川流不息
候鸟	留鸟
沃土	瘠田
物换星移	一成不变
稀疏	稠密||繁茂||茂密||密集
功昭日月	罪大恶极
哭穷	夸富
公历	农历
上装	卸装
单用	连用
死去活来	不痛不痒
寥落	稠密
艰深	浅易
群言堂	一言堂
一技之长	一无所长
马虎	仔细||认真
消失	出现||显现
民主	专政||专制
增加	节减
共性	个性
鹅行鸭步	高视阔步
转祸为福	转福为祸
熟悉	生疏||陌生
优势	劣势
公报私仇	克己奉公
云集	星散
免税	纳税
痛苦	幸福||欢乐||愉快
续	断
姹紫嫣红	残花败柳
月	日
兴盛	衰落
单刀赴会	群策群力
分外	分内
蜂拥而至	掩鼻而过
争	让
失去	获得||取得
造福	贻害||作孽
情深义重	食肉寝皮
全食	偏食
降龙伏虎	唯唯诺诺
一心二用	心无二用
售、	媾和
因材施教	一视同仁
简短	冗长
以攻为守	以守为攻
视若无睹	亲眼目睹
尊重	侮辱
光复	失陷
略胜一筹	棋逢对手
倾听	倾诉||倾吐
手疾眼快	笨手笨脚
放手	限制
五彩缤纷	一成不变
茂盛	残败||凋落||零落||枯萎
论功行赏	无功受禄
莺歌燕舞	鸡犬不宁
交叉	平行
黑洞洞	亮堂堂
残缺	完整
相煎何急	和睦相处
裁并	扩充
望眼欲穿	左右逢源
一	十
异乡	故乡
资产阶级	工人阶级||无产阶级
迷离恍惚	一目了然
低廉	昂贵
后进	先进
清正廉洁	贪污腐化
双管齐下	另起炉灶
流连忘返	迷途知返
韵文	散文
谈天说地	缄口不言
必然	偶然
招贤纳士	植党营私
守规矩	惹是非
粗浅	深奥
破格	逐级
拆散	组装
明说	暗示
旁边	正中
友好	敌对
沸汤沸止	釜底抽薪
崇高	卑下
意气扬扬	灰心丧气
学浅才疏	学富才高
轻重缓急	齐头并进
艰苦卓绝	好逸恶劳
沾亲带故	非亲非故
轻逸无论	坚苦卓绝
辩证法	形而上学
批判	赞颂
供不应求	供过于求
离散	完聚
复眼	单眼
冷静	冲动
少年	老翁
妥协	斗争
下不为例	不厌其烦||不乏先例
亲同手足	不共戴天
事前	事后
铤而走险	畏缩不前
稳固	动摇
人烟稀少	稠人广众
斗转星移	停滞不前
多	少
松	紧
饥	饱
否	是
埋藏	开掘
通	堵
曲	直
仆	主
首	末||尾
私	公
胖	瘦
稀	密||稠
亮	暗||黑
文	武
彼	此
蔑视	珍视||崇拜||崇敬||尊重
胜	败
败	胜
浓	淡
迎	送
古	今
敌	友
加	减
进	退
分	合
张	弛
苦不堪言	喜之不尽||无比欢欣
薄	厚
警	匪
迷迷糊糊	清清楚楚
清清楚楚	迷迷糊糊||模模糊糊
连续不断	断断续续
力倦神疲	精力充沛
暖暖和和	冷冷清清
毫不犹豫	犹豫不决
悔过自新	执迷不悟
翻来覆去	简单明了
昌盛	衰落
吵吵嚷嚷	冷冷清清
唇枪舌剑	心平气和
指鹿为马	实事求是||循名责实
希望	绝望||失望
追求	追逐
经验	无知
孤独	温暖
困难	容易||简单
贪心	知足||满足
通俗	高雅
蓬门荆布	金枝玉叶
寂寞	寂寞没有反义词,可以参考孤独的反义词||热闹
焦急	耐心||从容
严肃	活泼||郑重||随和
郑重	严肃||严肃||轻率||随便||随意
救援	无助
奇观	平淡
嫉妒	佩服||豁达
高耸	低平||低垂||巍峨
粗壮	孱弱||纤细||纤弱||瘦弱
健康	疾病||衰弱||生病||不适||虚弱
余音绕梁	不堪入耳
拘束	大方||放松||自由||逍遥||随便||不苛
凄凉	繁荣||热闹
真挚	虚伪||虚假
果然	居然||竟然
亲热	冷淡||冷漠
巨大	细小||微小||渺小||窄小
均匀	散乱||参差
偏僻	繁华
立即	犹豫
见微知著	原始见终||因小见大
粗心	细心
哀婉	欢快||欢快
遥远	咫尺
舒适	难受||痛苦||艰苦
惊讶	镇定
顽强	软弱||怯弱||脆弱||懦弱
特别	普通||一般||平常||平凡
狂风大作	风平浪静
隆重	低调||简单||草率
秘诀	常理||公开
正确	错误||错误||错误
质朴无华	珠光宝气||纸醉金迷
错误	正确
蛰伏	蠕动||雄飞||蠢动
急切	犹豫
惧怕	泰然
泰然	惧怕
慢悠悠	急匆匆
轻松	沉重||紧张||压抑
隐藏	暴露||公开
担忧	放心
贪婪	知足
闭关锁国	门户开放||面向世界
知足	贪婪
快乐	烦恼||苦恼||伤心||痛苦
注意	旁骛
统一	分裂||分化
分化	统一
分裂	统一
保存	删除||销毁
删除	保存
谨慎	马虎||粗心||轻率
晶莹	浑浊
鸡零狗碎	荦荦大端
忽然	悠然
悠然	忽然
赶快	缓慢
慈祥	凶恶||狰狞
肃穆	庄严||喧闹||喧哗||吵闹
执意	犹豫
惊诧	平静
倔强	温顺||柔顺
奇巧	平庸
学习	玩耍
注解	正文
情	仇
客	主
可能	应该||肯定||一定
起早	贪黑
寒冬腊月	盛夏酢暑
浑身	全身
激动	平静
年老	年幼
有求必应	拒之门外
哑然失笑	哄堂大笑||痛哭流涕
和婉	尖酸
薄情	多情
胆大包天	胆小如鼠
焚膏继晷	无所事事||饱食终日
枯木朽株	根深叶茂||万紫千红
羽毛未丰	羽毛丰满||羽翼已成
餐风露宿	悠哉游哉||席丰履厚
注销	登记
愁眉苦脸	春风满面||眉飞色舞||喜气洋洋||笑容可掬||满面春风||喜眉笑脸||笑逐颜开
僚机	长机
佶屈聱牙	琅琅上口||出口成章
升华	凝华
群魔乱舞	乐善好施
偷偷摸摸	正大光明||明目张胆||光明正大
省心	操心
孤岛	群岛
如梦方醒	黄梁美梦
风仪秀整	蓬头垢面
关内	关外
百战不殆	一败涂地
截长补短	将错就错
缄口结舌	口若悬河||大放厥词
隆冬	盛夏
子女	父母
好听	难听
执政	在野
白璧微瑕	白璧无瑕||完美无缺
应邀	邀请
心满意足	得寸进尺||心如刀绞
一花独放	百花齐放||万紫千红
师出有名	师出无名
相见恨晚	白头如新
积劳成疾	养尊处优
高八斗	才疏学浅
破镜重圆	覆水难收||生离死别||妻离子散
伤感	欣慰
残杯冷炙	山珍海味
宽大为怀	杀一儆百
散发	收集
暂短	长久
目不暇接	目不忍睹
走运	倒运
新式	老式
分别	见面
入耳	逆耳
正品	次品
秋	春
弄虚作假	实事求是
提要	全文
手到擒来	大海捞针
听天由命	改天换地||事在人为||何去何从
龙争虎斗	和平共处||团结友爱
枕戈待旦	高枕无忧||醉生梦死
细水长流	大手大脚
暗渡陈仓	明目张胆||明火执杖
以德报怨	倒打一耙||刻骨仇恨||结草衔环
十	一
引人注目	隐姓埋名
众擎易举	孤掌难鸣
提升	降低
一无所有	包罗万象||无所不有||无所不包||应有尽有
榜上有名	榜上无名
烦难	容易
里面	外面
大快人心	民怨沸腾
清心寡欲	多多益善
防御	进攻
鼓劲	泄气
独善其身	心怀天下
绘声绘色	平淡无奇
稀少	稠密||繁多||丰沛
饱满	空瘪||干瘪
怨	恩
质朴	华丽
利息	本金
披挂上阵	赤膊上阵
连	断
清	浑||污||浊
售	购
失传	流传
左右为难	左右逢源
肌瘦如柴	虎背熊腰
仁慈	残忍||暴虐||刁悍||毒辣||凶残
肄业	毕业
又红又专	只专不红||只红不专
繁盛	残败||枯萎
毫不留情	手下留情
元配	填房
现	隐
坚如磐石	分崩离析||摇摇欲坠||不堪一击||土崩瓦解
合情合理	不近人情||岂有此理
不伦不类	一本正经
公而忘私	假公济私||私而忘公||患得患失||假手于人||损公肥私
负心	痴情
耳软心活	固执己见
蹑手蹑脚	大大方方
风流倜傥	衣衫褴褛
前功尽弃	大功告成
奉为圭臬	视如敝屣||视如草芥
勾心斗角	肝胆相照||开诚布公||披肝沥胆||开诚相见
小我	大我
允许	禁止||反对
执法如山	手下留情||从宽发落
兵不血刃	血流漂杵||血流成河||血流飘杵
春	秋
顶撞	顺从
量入为出	入不敷出
无关痛痒	切肤之痛||事关全局||生死攸关
百家争鸣	万马齐喑
奉公守法	横行霸道||假公济私||贪赃枉法||违法乱纪
孤芳自赏	自惭形秽
紧张	和缓||弛缓||缓和||懒散||松弛||松懈||轻松
经天纬地	才疏学浅
束手待毙	垂死挣扎||困兽犹斗||应付自如
鸣锣喝道	无声无息
仁至义尽	不教而诛||惨无人道||作威作福||惨绝人寰||漠不关心
通权达变	墨守成规||刻舟求剑
新	旧||故
多灾多难	吉祥如意||吉人天相
牵强附会	顺理成章||天造地设
急如星火	慢条斯理||从容不迫
谴责	赞誉||称赞
扶植	压抑||铲除
虎头蛇尾	绳锯木断||水滴石穿||一以贯之||愚公移山||始终不懈||有头有尾
无忧无虑	含辛茹苦||心事重重||忧心忡忡
拿手好戏	一无所长||一无所能
生财有道	投机倒把
著名	无名
志同道合	道不同不相为谋||貌合神离||分道扬镳
放任自流	防患未然||揠苗助长
十恶不赦	罚不当罪||立功赎罪
高兴	苦恼||悲伤||沮丧||气愤||伤心||难过||痛苦
时间	空间
忐忑不安	泰然自若||悠然自得||心安理得
摇摇欲坠	傲然屹立||根深蒂固||岿然不动||安如磐石||坚如磐石
成功	失败
尾声	序曲||序幕
势如破竹	骑虎难下||强弩之末
失眠	安眠
废除	建立||施行||缔结||恢复
强人所难	挺身而出||心甘情愿||悉听尊便
大声疾呼	默不做声
恶毒	善良
好逸恶劳	不辞辛劳||艰苦卓绝||旰食宵衣
事倍功半	一本万利||一举两得||一箭双雕
豪情壮志	万念俱灰
似懂非懂	了如指掌
雪中送炭	乘人之危||落井下石||锦上添花||投井下石
若明若暗	一目了然
能工巧匠	酒囊饭袋
害处	好处
叶落归根	忘恩负义
批评	表扬||褒扬
瘠田	沃土
警惕	麻痹
亲密无间	不共戴天||敬而远之||若即若离||视同陌路||举目无亲||誓不两立
铁面无私	结党营私
干戈	玉帛
柔和	强烈||严厉
耳熟能详	寡闻少见
阴谋诡计	光明正大
矛	盾
守	攻
皎浩	昏暗
孜孜不倦	四体不勤，五谷不分||游手好闲
玉碎	瓦全
急流勇退	激流勇进||知难而进||急流勇进
以身试法	以身作则
苟全性命	宁死不屈
将	兵
终点	起点
巧言令色	疾言厉色||推心置腹
守正不阿	阿谀逢迎
可疑	可信
门户开放	闭关锁国
纤小	粗大
约略	精确
倾囊相助	一毛不拔
布衣	官绅
到达	起程||起身
逐级	破格||越级
长相厮守	人面桃花
失之交臂	不期而遇||旧雨重逢||冤家路窄||机不可失
照旧	更动||更换
落照	朝晖
中庸之道	偏听偏信
兴高采烈	百无聊赖||闷闷不乐||万箭攒心||郁郁不乐||无精打采||垂头丧气
凹	凸
呆	活
败家子	守财奴
瞻望	回顾
正言厉色	和颜悦色
恒产	动产
天公地道	徇私舞弊
下井投石	乐善好施
渺小	伟大
如鱼得水	釜底游鱼||寸步难行
变革	保守
新风	陋俗||旧俗
万古长存	遗臭万年
落荒而逃	得胜回朝
天下太平	国无宁日||天下大乱||动荡不安||金戈铁马
言归于好	话不投机
秀外慧中	獐头鼠目||贼眉贼眼
胆小怕事	初生牛犊不怕虎
没	有
民怨鼎沸	口碑载道
聪明	愚蠢||愚笨||糊涂
以讹传讹	衣钵相传||一脉相承
先生	学生
月初	月底||月末
内地	边疆||边陲
不胫而走	秘而不宣
变量	恒量
愁眉锁眼	喜气洋洋
清夜扪心	执迷不悟
永垂不朽	遗臭万年
团	尖
文治武功	文恬武嬉
花好月圆	花残月缺
举世闻名	默默无闻||无声无息||无声无臭
鼎盛	衰败
骨干	群众
忠贞不渝	见异思迁
诛求无已	廉政自守||两袖清风
打退堂鼓	勇往直前
言行不一	言行一致
藏龙卧虎	藏污纳垢||野无遗才
具体而微	硕大无朋
拖泥带水	干净利落||删繁就简||兔起鹘落||一刀两断||直截了当||惜墨如金||斩钉截铁
吃斋	吃荤
力大无穷	黔驴技穷||黔驴之计
言听计从	我行我素
急公近利	高瞻远瞩||深谋远虑
龙吟虎啸	不绝如缕||燕语莺声
无动于衷	百感交集||睹物思人||感慨万千||感人肺腑||扣人心弦||情不自禁||震撼人心||触景生情||感激涕零||感慨系之||金石为开||潜移默化
和	唱||战
成心	无意
停刊	复刊
鄙薄	重视
泪如泉涌	纵声大笑||捧腹大笑
鲁莽	持重
拔	扎||栽
赫赫有名	默默无闻||无名英雄
热带	寒带
一往直前	瞻前顾后
扼要	累赘
负荆请罪	兴师问罪
